S.No.,CITY 1,CITY 2,AVG FLIGHTS TO CITY 2,AVG FLIGHTS FROM CITY 2,TOTAL AVG FLIGHTS
1,AGARTALA,AHMEDABAD,1,2,3
2,AGARTALA,AIZAWL,4,3,7
3,AGARTALA,BENGALURU,36,32,68
4,AGARTALA,DELHI,43,43,86
5,AGARTALA,DIBRUGARH,8,8,16
6,AGARTALA,GUWAHATI,46,48,94
7,AGARTALA,IMPHAL,12,15,27
8,AGARTALA,KOLKATA,334,320,654
9,AGARTALA,SHILLONG,7,6,13
10,AGATTI ISLAND,BENGALURU,1,1,2
11,AGATTI ISLAND,KOCHI,12,15,27
12,AGATTI ISLAND,MYSORE,1,1,2
13,AGRA,BENGALURU,25,25,50
14,AGRA,BHOPAL,2,3,5
15,AGRA,LUCKNOW,5,6,11
16,AHMEDABAD,AMRITSAR,21,22,43
17,AHMEDABAD,BAGDOGRA,10,7,17
18,AHMEDABAD,BELGAUM,7,7,14
19,AHMEDABAD,BENGALURU,269,268,537
20,AHMEDABAD,BHOPAL,18,17,35
21,AHMEDABAD,CHANDIGARH,44,39,83
22,AHMEDABAD,CHENNAI,99,97,196
24,AHMEDABAD,DABOLIM,127,134,261
25,AHMEDABAD,DEHRA DUN,23,22,45
26,AHMEDABAD,DELHI,695,630,1325
27,AHMEDABAD,DURGAPUR,1,2,3
28,AHMEDABAD,GUWAHATI,2,2,4
29,AHMEDABAD,GWALIOR,17,17,34
30,AHMEDABAD,HYDERABAD,146,142,288
31,AHMEDABAD,INDORE,20,18,38
32,AHMEDABAD,JAIPUR,69,67,136
33,AHMEDABAD,KOLKATA,177,144,321
34,AHMEDABAD,LUCKNOW,84,69,153
35,AHMEDABAD,MUMBAI,443,445,888
36,AHMEDABAD,NAGPUR,20,20,40
37,AHMEDABAD,NASIK,10,9,19
38,AHMEDABAD,PATNA,50,48,98
39,AHMEDABAD,PUNE,116,112,228
40,AHMEDABAD,SHIRDI,2,2,4
41,AHMEDABAD,VARANASI,28,18,46
42,AHMEDABAD,VISAKHAPATNAM,4,4,8
43,AIZAWL,DELHI,17,17,34
44,AIZAWL,GUWAHATI,38,31,69
45,AIZAWL,IMPHAL,4,5,9
46,AIZAWL,KOLKATA,55,55,110
47,AIZAWL,MUMBAI,1,1,2
48,AIZAWL,SHILLONG,5,4,9
49,AJMER,DELHI,17,18,35
50,AJMER,HYDERABAD,21,22,43
51,AJMER,INDORE,4,5,9
52,AJMER,MUMBAI,16,17,33
53,AJMER,SURAT,4,5,9
54,ALLAHABAD,BENGALURU,42,44,86
55,ALLAHABAD,BHOPAL,9,10,19
56,ALLAHABAD,BHUBANESWAR,17,19,36
57,ALLAHABAD,BILASPUR,4,4,8
58,ALLAHABAD,DEHRA DUN,14,15,29
59,ALLAHABAD,DELHI,41,45,86
60,ALLAHABAD,GORAKHPUR,12,9,21
61,ALLAHABAD,INDORE,10,12,22
62,ALLAHABAD,JABALPUR,1,1,2
63,ALLAHABAD,LUCKNOW,9,9,18
64,ALLAHABAD,MUMBAI,42,47,89
65,ALLAHABAD,PUNE,18,19,37
66,ALLAHABAD,RAIPUR,19,18,37
67,AMRITSAR,BENGALURU,22,29,51
68,AMRITSAR,CHENNAI,2,2,4
69,AMRITSAR,DABOLIM,17,23,40
70,AMRITSAR,DELHI,295,291,586
71,AMRITSAR,GUWAHATI,5,5,10
72,AMRITSAR,JAIPUR,12,12,24
74,AMRITSAR,KOLKATA,42,40,82
75,AMRITSAR,LUCKNOW,16,11,27
76,AMRITSAR,MUMBAI,136,142,278
77,AMRITSAR,PATNA,15,13,28
78,AMRITSAR,PUNE,33,41,74
79,AMRITSAR,SRINAGAR,83,67,150
80,AURANGABAD,DELHI,69,66,135
81,AURANGABAD,HYDERABAD,21,19,40
82,AURANGABAD,MUMBAI,60,59,119
83,BAGDOGRA,BENGALURU,64,68,132
84,BAGDOGRA,CHENNAI,36,40,76
85,BAGDOGRA,DELHI,174,185,359
86,BAGDOGRA,DIBRUGARH,8,8,16
88,BAGDOGRA,HYDERABAD,25,25,50
89,BAGDOGRA,KOLKATA,140,146,286
90,BAGDOGRA,MUMBAI,63,66,129
91,BAGDOGRA,RANCHI,1,1,2
92,BAREILLY,BENGALURU,25,25,50
93,BAREILLY,DELHI,15,13,28
94,BAREILLY,MUMBAI,30,34,64
95,BELGAUM,BENGALURU,20,19,39
96,BELGAUM,DELHI,42,40,82
97,BELGAUM,HYDERABAD,36,34,70
98,BELGAUM,INDORE,5,5,10
99,BELGAUM,JODHPUR,6,5,11
100,BELGAUM,MUMBAI,30,30,60
101,BELGAUM,NAGPUR,2,2,4
102,BELGAUM,NASIK,6,5,11
103,BELGAUM,PUNE,9,8,17
104,BELGAUM,SURAT,5,5,10
105,BELGAUM,TIRUPATI,4,3,7
106,BENGALURU,BHOPAL,39,42,81
107,BENGALURU,BHUBANESWAR,210,210,420
108,BENGALURU,CHANDIGARH,157,146,303
109,BENGALURU,CHENNAI,311,320,631
110,BENGALURU,COIMBATORE,91,102,193
111,BENGALURU,DABOLIM,364,367,731
112,BENGALURU,DARBHANGA,94,81,175
113,BENGALURU,DEHRA DUN,44,44,88
114,BENGALURU,DELHI,1595,1568,3163
115,BENGALURU,DIMAPUR,7,4,11
116,BENGALURU,DURGAPUR,40,47,87
117,BENGALURU,GORAKHPUR,9,15,24
118,BENGALURU,GUWAHATI,244,213,457
119,BENGALURU,GWALIOR,22,22,44
120,BENGALURU,HUBLI,43,43,86
121,BENGALURU,HYDERABAD,564,563,1127
122,BENGALURU,IMPHAL,12,13,25
123,BENGALURU,INDORE,86,85,171
124,BENGALURU,JABALPUR,23,22,45
125,BENGALURU,JAIPUR,183,180,363
126,BENGALURU,JAMMU,4,5,9
127,BENGALURU,JAMNAGAR,6,5,11
128,BENGALURU,JHARSUGUDA,24,23,47
129,BENGALURU,JODHPUR,35,35,70
130,BENGALURU,JORHAT,6,6,12
131,BENGALURU,KADAPA,2,3,5
132,BENGALURU,"KALABURAGI, KARNATAKA",27,28,55
133,BENGALURU,KANNUR,27,25,52
134,BENGALURU,KANPUR,37,40,77
135,BENGALURU,KOCHI,388,371,759
136,BENGALURU,KOLHAPUR,7,6,13
137,BENGALURU,KOLKATA,717,641,1358
138,BENGALURU,KOZHIKODE,19,20,39
139,BENGALURU,KURNOOL,6,7,13
140,BENGALURU,LUCKNOW,214,190,404
141,BENGALURU,MADURAI,52,53,105
142,BENGALURU,MANGALORE,184,178,362
143,BENGALURU,MUMBAI,1158,1157,2315
144,BENGALURU,MYSORE,4,7,11
145,BENGALURU,NAGPUR,95,102,197
146,BENGALURU,PATNA,243,209,452
147,BENGALURU,PONDICHERRY,15,17,32
148,BENGALURU,PORT BLAIR,78,75,153
149,BENGALURU,PUNE,401,410,811
150,BENGALURU,RAIPUR,70,71,141
151,BENGALURU,RAJAHMUNDRY,34,37,71
152,BENGALURU,RAJKOT,36,40,76
153,BENGALURU,RANCHI,148,137,285
154,BENGALURU,SHIRDI,68,66,134
155,BENGALURU,SRINAGAR,16,20,36
156,BENGALURU,SURAT,58,59,117
157,BENGALURU,TIRUCHIRAPALLY,31,29,60
158,BENGALURU,TIRUPATI,19,18,37
159,BENGALURU,TRIVANDRUM,157,158,315
160,BENGALURU,TUTICORIN,16,15,31
161,BENGALURU,UDAIPUR,29,30,59
162,BENGALURU,VADODARA,54,52,106
163,BENGALURU,VARANASI,146,146,292
164,BENGALURU,VIJAYAWADA,69,75,144
165,BENGALURU,VISAKHAPATNAM,146,153,299
166,BHAVNAGAR,MUMBAI,5,6,11
167,BHOPAL,CHENNAI,10,15,25
168,BHOPAL,DELHI,167,148,315
169,BHOPAL,HYDERABAD,26,23,49
170,BHOPAL,KOCHI,4,5,9
171,BHOPAL,MUMBAI,117,116,233
172,BHOPAL,PUNE,13,11,24
173,BHOPAL,RAIPUR,17,19,36
174,BHUBANESWAR,CHANDIGARH,6,5,11
175,BHUBANESWAR,CHENNAI,70,78,148
177,BHUBANESWAR,DELHI,360,368,728
178,BHUBANESWAR,HYDERABAD,121,134,255
179,BHUBANESWAR,JAIPUR,20,20,40
180,BHUBANESWAR,JHARSUGUDA,12,12,24
181,BHUBANESWAR,KOLKATA,177,176,353
182,BHUBANESWAR,LUCKNOW,3,4,7
183,BHUBANESWAR,MUMBAI,170,174,344
184,BHUBANESWAR,PATNA,31,29,60
185,BHUBANESWAR,PUNE,48,45,93
186,BHUBANESWAR,RAIPUR,19,15,34
187,BHUBANESWAR,RANCHI,4,4,8
188,BHUBANESWAR,VARANASI,17,18,35
189,BHUJ,MUMBAI,10,11,21
190,BIKANER,DELHI,12,13,25
191,BILASPUR,DELHI,4,5,9
192,BILASPUR,JABALPUR,3,4,7
193,CHANDIGARH,CHENNAI,33,46,79
194,CHANDIGARH,DABOLIM,54,59,113
195,CHANDIGARH,DELHI,301,314,615
196,CHANDIGARH,DHARAMSALA,10,10,20
197,CHANDIGARH,GUWAHATI,1,1,2
198,CHANDIGARH,HYDERABAD,118,144,262
199,CHANDIGARH,JAIPUR,37,31,68
201,CHANDIGARH,KOLKATA,25,30,55
202,CHANDIGARH,KULLU,5,1,6
203,CHANDIGARH,LEH,8,12,20
204,CHANDIGARH,LUCKNOW,35,37,72
205,CHANDIGARH,MUMBAI,364,416,780
206,CHANDIGARH,PATNA,36,33,69
207,CHANDIGARH,PUNE,48,45,93
208,CHANDIGARH,SRINAGAR,106,91,197
209,CHANDIGARH,VADODARA,2,3,5
210,CHENNAI,COIMBATORE,279,274,553
211,CHENNAI,DABOLIM,47,48,95
212,CHENNAI,DARBHANGA,4,2,6
213,CHENNAI,DEHRA DUN,7,7,14
214,CHENNAI,DELHI,767,754,1521
215,CHENNAI,DIBRUGARH,8,7,15
216,CHENNAI,DURGAPUR,48,39,87
218,CHENNAI,GUWAHATI,158,133,291
219,CHENNAI,HUBLI,16,16,32
220,CHENNAI,HYDERABAD,418,404,822
221,CHENNAI,INDORE,29,35,64
222,CHENNAI,JAIPUR,61,54,115
223,CHENNAI,JODHPUR,49,45,94
224,CHENNAI,KADAPA,3,4,7
225,CHENNAI,KANNUR,20,19,39
226,CHENNAI,KOCHI,168,168,336
227,CHENNAI,KOLKATA,432,361,793
228,CHENNAI,KOZHIKODE,18,20,38
229,CHENNAI,KURNOOL,6,6,12
230,CHENNAI,LUCKNOW,38,36,74
231,CHENNAI,MADURAI,120,117,237
232,CHENNAI,MANGALORE,21,19,40
233,CHENNAI,MUMBAI,590,590,1180
234,CHENNAI,MYSORE,17,17,34
235,CHENNAI,NAGPUR,30,23,53
236,CHENNAI,PATNA,46,38,84
237,CHENNAI,PORT BLAIR,134,142,276
238,CHENNAI,PUNE,194,203,397
239,CHENNAI,RAIPUR,24,25,49
240,CHENNAI,RAJAHMUNDRY,13,15,28
241,CHENNAI,RANCHI,31,34,65
242,CHENNAI,SHIRDI,59,55,114
243,CHENNAI,SRINAGAR,10,8,18
244,CHENNAI,SURAT,29,26,55
245,CHENNAI,TIRUCHIRAPALLY,59,51,110
246,CHENNAI,TRIVANDRUM,116,110,226
247,CHENNAI,TUTICORIN,65,63,128
248,CHENNAI,UDAIPUR,2,1,3
249,CHENNAI,VADODARA,26,24,50
250,CHENNAI,VARANASI,25,23,48
251,CHENNAI,VIJAYAWADA,27,31,58
252,CHENNAI,VISAKHAPATNAM,96,101,197
254,COIMBATORE,DELHI,101,99,200
255,COIMBATORE,GUWAHATI,4,2,6
256,COIMBATORE,HYDERABAD,164,167,331
257,COIMBATORE,JAIPUR,6,4,10
258,COIMBATORE,MUMBAI,140,142,282
259,COIMBATORE,PUNE,43,36,79
260,COIMBATORE,SURAT,4,4,8
261,COIMBATORE,TIRUPATI,2,3,5
263,DABOLIM,DELHI,743,694,1437
264,DABOLIM,GUWAHATI,8,1,9
265,DABOLIM,HYDERABAD,396,378,774
266,DABOLIM,INDORE,34,34,68
267,DABOLIM,JAIPUR,45,41,86
268,DABOLIM,KANNUR,7,8,15
269,DABOLIM,KOLKATA,81,67,148
270,DABOLIM,LUCKNOW,37,37,74
271,DABOLIM,MUMBAI,750,739,1489
272,DABOLIM,MYSORE,10,11,21
273,DABOLIM,NAGPUR,27,27,54
274,DABOLIM,PUNE,79,76,155
275,DABOLIM,RAIPUR,8,11,19
276,DABOLIM,RAJKOT,20,19,39
277,DABOLIM,SURAT,37,38,75
278,DARBHANGA,DELHI,110,111,221
279,DARBHANGA,HYDERABAD,22,26,48
280,DARBHANGA,KOLKATA,16,19,35
281,DARBHANGA,MUMBAI,63,85,148
282,DEHRA DUN,DELHI,235,258,493
283,DEHRA DUN,GUWAHATI,7,6,13
284,DEHRA DUN,HYDERABAD,37,41,78
285,DEHRA DUN,JAIPUR,32,31,63
286,DEHRA DUN,KOLKATA,22,21,43
287,DEHRA DUN,LUCKNOW,37,40,77
288,DEHRA DUN,MUMBAI,132,145,277
289,DEHRA DUN,PANTNAGAR,16,15,31
290,DEHRA DUN,PUNE,6,7,13
291,DEHRA DUN,VARANASI,11,10,21
292,DELHI,DHARAMSALA,85,74,159
293,DELHI,DIBRUGARH,121,85,206
294,DELHI,DIMAPUR,23,25,48
295,DELHI,DURGAPUR,46,42,88
296,DELHI,GAYA,43,39,82
297,DELHI,GORAKHPUR,140,100,240
298,DELHI,GUWAHATI,564,557,1121
299,DELHI,GWALIOR,11,14,25
300,DELHI,HYDERABAD,960,956,1916
301,DELHI,IMPHAL,79,84,163
302,DELHI,INDORE,283,293,576
303,DELHI,JABALPUR,73,68,141
304,DELHI,JAIPUR,158,146,304
305,DELHI,JAMMU,386,388,774
306,DELHI,JHARSUGUDA,50,49,99
307,DELHI,JODHPUR,86,81,167
308,DELHI,JORHAT,10,10,20
309,DELHI,KANDLA,23,20,43
310,DELHI,KANNUR,14,13,27
311,DELHI,KANPUR,23,23,46
312,DELHI,KHAJURAHO,5,5,10
313,DELHI,KOCHI,344,352,696
314,DELHI,KOLKATA,1049,925,1974
315,DELHI,KOZHIKODE,61,63,124
316,DELHI,KULLU,7,4,11
317,DELHI,LEH,493,348,841
318,DELHI,LUCKNOW,443,406,849
319,DELHI,MADURAI,35,37,72
320,DELHI,MANGALORE,5,4,9
321,DELHI,MUMBAI,1948,2081,4029
322,DELHI,NAGPUR,195,211,406
323,DELHI,NASIK,4,5,9
324,DELHI,PAKYONG,13,11,24
325,DELHI,PANTNAGAR,31,30,61
326,DELHI,PATHANKOT,5,6,11
327,DELHI,PATNA,679,498,1177
328,DELHI,PORBANDAR,1,1,2
329,DELHI,PORT BLAIR,28,28,56
330,DELHI,PUNE,852,867,1719
331,DELHI,RAIPUR,264,276,540
332,DELHI,RAJKOT,110,126,236
333,DELHI,RANCHI,375,323,698
334,DELHI,SHIRDI,89,88,177
335,DELHI,SILCHAR,17,16,33
336,DELHI,SRINAGAR,1313,1180,2493
337,DELHI,SURAT,182,191,373
338,DELHI,TIRUCHIRAPALLY,8,6,14
339,DELHI,TIRUPATI,20,18,38
340,DELHI,TRIVANDRUM,106,110,216
341,DELHI,UDAIPUR,127,130,257
342,DELHI,VADODARA,156,183,339
343,DELHI,VARANASI,354,287,641
344,DELHI,VIJAYAWADA,47,48,95
345,DELHI,VISAKHAPATNAM,167,163,330
346,DELHI,Kushinagar International Airport,16,14,30
347,DHARAMSALA,JAIPUR,11,18,29
348,DIBRUGARH,DIMAPUR,2,2,4
349,DIBRUGARH,GUWAHATI,47,41,88
350,DIBRUGARH,IMPHAL,7,8,15
351,DIBRUGARH,KOLKATA,99,92,191
352,DIBRUGARH,MUMBAI,3,4,7
353,DIBRUGARH,SHILLONG,4,4,8
354,DIMAPUR,GUWAHATI,7,7,14
355,DIMAPUR,IMPHAL,11,13,24
356,DIMAPUR,KOLKATA,53,46,99
357,DIMAPUR,MUMBAI,1,1,2
358,DIMAPUR,SHILLONG,1,1,2
359,DIU,MUMBAI,16,16,32
360,DURGAPUR,GUWAHATI,8,10,18
361,DURGAPUR,HYDERABAD,24,26,50
362,DURGAPUR,MUMBAI,43,45,88
363,DURGAPUR,TRIVANDRUM,1,1,2
365,GAYA,KOLKATA,17,15,32
366,GAYA,MUMBAI,3,3,6
367,GHAZIABAD,HUBLI,7,7,14
368,GHAZIABAD,"KALABURAGI, KARNATAKA",5,5,10
369,GORAKHPUR,HYDERABAD,30,40,70
371,GORAKHPUR,KANPUR,5,5,10
372,GORAKHPUR,KOLKATA,17,18,35
374,GORAKHPUR,MUMBAI,69,93,162
375,GORAKHPUR,VARANASI,9,6,15
376,GUWAHATI,HYDERABAD,44,45,89
377,GUWAHATI,IMPHAL,130,154,284
378,GUWAHATI,JAIPUR,55,56,111
379,GUWAHATI,JODHPUR,2,3,5
380,GUWAHATI,JORHAT,7,8,15
381,GUWAHATI,KOLKATA,334,381,715
382,GUWAHATI,LILABARI,4,4,8
383,GUWAHATI,LUCKNOW,40,37,77
384,GUWAHATI,MUMBAI,126,129,255
385,GUWAHATI,PASIGHAT,4,3,7
386,GUWAHATI,PATNA,30,35,65
387,GUWAHATI,PUNE,45,48,93
388,GUWAHATI,RUPSI,7,4,11
389,GUWAHATI,SHILLONG,1,1,2
390,GUWAHATI,SILCHAR,27,27,54
391,GUWAHATI,TEZPUR,2,1,3
392,GUWAHATI,TEZU,3,5,8
393,GUWAHATI,VARANASI,14,13,27
394,GWALIOR,HYDERABAD,15,18,33
395,GWALIOR,INDORE,10,13,23
396,GWALIOR,JAMMU,10,11,21
397,GWALIOR,KOLKATA,17,15,32
398,GWALIOR,MUMBAI,17,16,33
399,HUBLI,HYDERABAD,3,3,6
400,HUBLI,KANNUR,4,4,8
401,HUBLI,MUMBAI,18,19,37
402,HUBLI,TIRUPATI,3,3,6
403,HYDERABAD,IMPHAL,2,1,3
404,HYDERABAD,INDORE,109,119,228
405,HYDERABAD,JABALPUR,21,25,46
406,HYDERABAD,JAGDALPUR,11,11,22
407,HYDERABAD,JAIPUR,163,136,299
409,HYDERABAD,JAMNAGAR,6,6,12
410,HYDERABAD,JHARSUGUDA,21,17,38
411,HYDERABAD,JODHPUR,18,18,36
412,HYDERABAD,KADAPA,10,10,20
413,HYDERABAD,KANNUR,18,18,36
414,HYDERABAD,KOCHI,172,159,331
415,HYDERABAD,KOLHAPUR,29,28,57
416,HYDERABAD,KOLKATA,405,317,722
417,HYDERABAD,KOZHIKODE,19,19,38
418,HYDERABAD,LUCKNOW,97,89,186
419,HYDERABAD,MADURAI,39,38,77
420,HYDERABAD,MANGALORE,38,39,77
421,HYDERABAD,MUMBAI,555,564,1119
422,HYDERABAD,MYSORE,26,26,52
423,HYDERABAD,NAGPUR,18,19,37
424,HYDERABAD,PATNA,116,79,195
425,HYDERABAD,PONDICHERRY,20,20,40
426,HYDERABAD,PORT BLAIR,18,17,35
427,HYDERABAD,PUNE,103,115,218
428,HYDERABAD,RAIPUR,80,76,156
429,HYDERABAD,RAJAHMUNDRY,86,88,174
430,HYDERABAD,RANCHI,79,70,149
431,HYDERABAD,SHIRDI,63,66,129
432,HYDERABAD,SRINAGAR,34,34,68
433,HYDERABAD,SURAT,36,41,77
434,HYDERABAD,TIRUCHIRAPALLY,23,18,41
435,HYDERABAD,TIRUPATI,212,209,421
436,HYDERABAD,TRIVANDRUM,69,64,133
437,HYDERABAD,UDAIPUR,31,31,62
438,HYDERABAD,VADODARA,50,49,99
439,HYDERABAD,VARANASI,92,94,186
440,HYDERABAD,VIJAYAWADA,94,97,191
441,HYDERABAD,VISAKHAPATNAM,301,280,581
442,IMPHAL,KOLKATA,143,120,263
443,IMPHAL,MUMBAI,3,3,6
444,IMPHAL,SHILLONG,8,7,15
445,INDORE,JABALPUR,11,12,23
446,INDORE,JAIPUR,30,29,59
447,INDORE,JAMMU,22,18,40
448,INDORE,KOLKATA,27,28,55
449,INDORE,LUCKNOW,20,21,41
450,INDORE,MUMBAI,197,207,404
451,INDORE,NAGPUR,16,17,33
452,INDORE,PUNE,35,35,70
453,INDORE,RAIPUR,48,43,91
456,JABALPUR,MUMBAI,43,48,91
457,JABALPUR,PUNE,18,19,37
458,JAGDALPUR,RAIPUR,11,11,22
459,JAIPUR,KOLKATA,120,133,253
460,JAIPUR,LUCKNOW,19,18,37
461,JAIPUR,MUMBAI,332,374,706
462,JAIPUR,PATNA,30,29,59
463,JAIPUR,PUNE,94,85,179
464,JAIPUR,SURAT,25,26,51
465,JAIPUR,VADODARA,7,9,16
466,JAIPUR,VARANASI,15,13,28
467,JAMMU,KOLKATA,1,2,3
468,JAMMU,LEH,18,34,52
469,JAMMU,MUMBAI,11,70,81
470,JAMMU,SRINAGAR,177,137,314
471,JAMMU,VARANASI,7,7,14
472,JAMNAGAR,MUMBAI,30,32,62
473,JHARSUGUDA,KOLKATA,30,24,54
474,JHARSUGUDA,RAIPUR,8,5,13
475,JODHPUR,KOLKATA,14,15,29
476,JODHPUR,MUMBAI,50,50,100
477,JORHAT,KOLKATA,35,37,72
478,KADAPA,VIJAYAWADA,3,2,5
479,KADAPA,VISAKHAPATNAM,6,6,12
480,"KALABURAGI, KARNATAKA",TIRUPATI,6,5,11
481,KANDLA,MUMBAI,21,21,42
482,KANNUR,KOCHI,21,20,41
483,KANNUR,KOZHIKODE,1,2,3
484,KANNUR,MUMBAI,28,40,68
485,KANNUR,TRIVANDRUM,20,18,38
486,KANPUR,MUMBAI,53,70,123
487,KOCHI,KOLKATA,38,43,81
488,KOCHI,MUMBAI,318,336,654
489,KOCHI,MYSORE,9,9,18
490,KOCHI,PUNE,42,44,86
491,KOCHI,RANCHI,4,3,7
492,KOCHI,TRIVANDRUM,19,18,37
493,KOLHAPUR,TIRUPATI,16,18,34
494,KOLKATA,LILABARI,8,9,17
495,KOLKATA,LUCKNOW,82,83,165
496,KOLKATA,MANGALORE,4,5,9
497,KOLKATA,MUMBAI,542,619,1161
498,KOLKATA,NAGPUR,34,40,74
499,KOLKATA,PAKYONG,12,11,23
501,KOLKATA,PATNA,78,71,149
502,KOLKATA,PORT BLAIR,137,178,315
503,KOLKATA,PUNE,84,95,179
504,KOLKATA,RAIPUR,59,79,138
505,KOLKATA,RANCHI,55,52,107
506,KOLKATA,RUPSI,11,12,23
507,KOLKATA,SHILLONG,18,13,31
508,KOLKATA,SILCHAR,81,77,158
509,KOLKATA,SRINAGAR,24,19,43
510,KOLKATA,SURAT,38,40,78
512,KOLKATA,TRIVANDRUM,5,2,7
513,KOLKATA,VARANASI,41,42,83
514,KOLKATA,VISAKHAPATNAM,41,50,91
515,KOZHIKODE,MUMBAI,72,71,143
516,KURNOOL,VISAKHAPATNAM,7,7,14
518,LEH,SRINAGAR,40,10,50
519,LUCKNOW,MUMBAI,201,301,502
520,LUCKNOW,NAGPUR,18,18,36
521,LUCKNOW,PATNA,34,30,64
522,LUCKNOW,PUNE,46,43,89
523,LUCKNOW,RAIPUR,16,15,31
524,LUCKNOW,RANCHI,32,31,63
525,LUCKNOW,SRINAGAR,11,12,23
526,MADURAI,MUMBAI,47,53,100
527,MADURAI,TIRUPATI,7,6,13
528,MADURAI,VIJAYAWADA,2,2,4
529,MANGALORE,MUMBAI,206,225,431
530,MANGALORE,PUNE,12,16,28
531,MUMBAI,NAGPUR,273,293,566
532,MUMBAI,PATNA,201,145,346
533,MUMBAI,PORBANDAR,17,15,32
535,MUMBAI,PUNE,1,1,2
536,MUMBAI,RAIPUR,142,147,289
537,MUMBAI,RAJKOT,116,110,226
538,MUMBAI,RANCHI,128,134,262
539,MUMBAI,SILCHAR,1,1,2
540,MUMBAI,SRINAGAR,169,247,416
541,MUMBAI,SURAT,17,16,33
542,MUMBAI,TIRUPATI,15,14,29
543,MUMBAI,TRIVANDRUM,82,90,172
544,MUMBAI,UDAIPUR,151,145,296
545,MUMBAI,VADODARA,140,149,289
546,MUMBAI,VARANASI,271,208,479
548,MUMBAI,VISAKHAPATNAM,55,62,117
549,MUMBAI,Sindhudurg Airport,17,16,33
550,NAGPUR,PUNE,146,131,277
552,NASIK,PUNE,10,9,19
553,PASIGHAT,TEZPUR,1,1,2
554,PATNA,PUNE,61,63,124
555,PATNA,RANCHI,31,31,62
556,PATNA,VARANASI,6,7,13
557,PORT BLAIR,VISAKHAPATNAM,13,11,24
558,PUNE,RAIPUR,23,20,43
559,PUNE,RANCHI,44,39,83
560,PUNE,SURAT,9,8,17
561,PUNE,TIRUPATI,12,12,24
562,PUNE,TRIVANDRUM,25,21,46
563,PUNE,VISAKHAPATNAM,12,11,23
564,RAIPUR,SRINAGAR,5,4,9
566,RAJAHMUNDRY,TIRUPATI,6,5,11
567,RAJAHMUNDRY,VISAKHAPATNAM,7,5,12
568,RANCHI,VARANASI,1,1,2
569,SHILLONG,SILCHAR,3,3,6
570,SHIRDI,TIRUPATI,9,8,17
572,TIRUCHIRAPALLY,TIRUPATI,2,2,4
573,TIRUPATI,VIJAYAWADA,7,8,15
574,TIRUPATI,VISAKHAPATNAM,17,18,35
575,VIJAYAWADA,VISAKHAPATNAM,19,19,38
576,Gondia Airport,HYDERABAD,9,9,18
577,Gondia Airport,INDORE,11,10,21
