S.No.,CITY 1,CITY 2,AVG FLIGHTS TO CITY 2,AVG FLIGHTS FROM CITY 2,TOTAL AVG FLIGHTS
1,AGRA,AHMEDABAD,5,6,11
2,AGRA,BENGALURU,23,23,46
3,AGRA,BHOPAL,2,2,4
4,AGRA,LUCKNOW,4,5,9
5,AGRA,MUMBAI,17,17,34
6,AGATTI ISLAND,BENGALURU,1,1,2
7,AGATTI ISLAND,KOCHI,15,19,34
8,AGATTI ISLAND,MYSORE,1,1,2
10,AIZAWL,DELHI,18,17,35
11,AIZAWL,GUWAHATI,40,35,75
12,AIZAWL,IMPHAL,4,4,8
13,AIZAWL,KOLKATA,46,48,94
14,AIZAWL,MUMBAI,3,2,5
15,AIZAWL,SHILLONG,4,5,9
16,AHMEDABAD,AMRITSAR,11,11,22
17,AHMEDABAD,BAGDOGRA,6,3,9
18,AHMEDABAD,BELGAUM,7,8,15
19,AHMEDABAD,BENGALURU,272,285,557
20,AHMEDABAD,BHOPAL,15,19,34
21,AHMEDABAD,BHUJ,6,5,11
22,AHMEDABAD,CHANDIGARH,57,50,107
23,AHMEDABAD,CHENNAI,111,108,219
24,AHMEDABAD,COIMBATORE,10,7,17
25,AHMEDABAD,DABOLIM,150,156,306
26,AHMEDABAD,DEHRA DUN,60,57,117
27,AHMEDABAD,DELHI,644,673,1317
28,AHMEDABAD,DURGAPUR,2,2,4
29,AHMEDABAD,GUWAHATI,8,9,17
30,AHMEDABAD,GWALIOR,7,7,14
31,AHMEDABAD,HYDERABAD,126,126,252
32,AHMEDABAD,INDORE,19,20,39
33,AHMEDABAD,JAIPUR,67,63,130
34,AHMEDABAD,JODHPUR,15,15,30
35,AHMEDABAD,KOCHI,32,27,59
36,AHMEDABAD,KOLHAPUR,6,6,12
37,AHMEDABAD,KOLKATA,133,146,279
38,AHMEDABAD,LUCKNOW,63,62,125
39,AHMEDABAD,MUMBAI,643,588,1231
40,AHMEDABAD,NAGPUR,26,24,50
41,AHMEDABAD,NASIK,8,7,15
42,AHMEDABAD,PATNA,50,54,104
43,AHMEDABAD,PUNE,140,138,278
44,AHMEDABAD,RAIPUR,25,23,48
45,AHMEDABAD,RANCHI,13,15,28
46,AHMEDABAD,SHIRDI,1,1,2
47,AHMEDABAD,TRIVANDRUM,3,3,6
48,AHMEDABAD,VARANASI,42,47,89
49,AHMEDABAD,VISAKHAPATNAM,5,3,8
50,AMRITSAR,BENGALURU,24,23,47
51,AMRITSAR,CHENNAI,2,2,4
53,AMRITSAR,DELHI,255,265,520
54,AMRITSAR,GUWAHATI,1,3,4
55,AMRITSAR,JAIPUR,2,2,4
57,AMRITSAR,KOLKATA,45,45,90
58,AMRITSAR,LUCKNOW,15,13,28
59,AMRITSAR,MUMBAI,114,103,217
60,AMRITSAR,PATNA,10,12,22
61,AMRITSAR,PUNE,25,27,52
62,AMRITSAR,SRINAGAR,48,52,100
63,BHUBANESWAR,CHANDIGARH,7,7,14
64,BHUBANESWAR,CHENNAI,72,71,143
66,BHUBANESWAR,DELHI,321,318,639
67,BHUBANESWAR,HYDERABAD,115,107,222
68,BHUBANESWAR,JAIPUR,15,17,32
69,BHUBANESWAR,JHARSUGUDA,13,13,26
70,BHUBANESWAR,KOLKATA,122,132,254
71,ALLAHABAD,JABALPUR,1,1,2
72,BHUBANESWAR,LUCKNOW,2,4,6
73,BHUBANESWAR,MUMBAI,184,171,355
74,BHUBANESWAR,PATNA,30,28,58
75,BHUBANESWAR,PUNE,34,31,65
76,BHUBANESWAR,RAIPUR,13,12,25
77,AMRITSAR,CHANDIGARH,3,1,4
78,BHUBANESWAR,RANCHI,6,5,11
79,BHUBANESWAR,VARANASI,14,14,28
80,BAREILLY,BENGALURU,19,16,35
81,BAREILLY,DELHI,15,12,27
82,BAREILLY,MUMBAI,21,21,42
83,BHUJ,MUMBAI,10,10,20
84,BHOPAL,DELHI,169,159,328
85,BHOPAL,HYDERABAD,18,17,35
86,BHOPAL,KOCHI,7,6,13
87,BHOPAL,MUMBAI,121,109,230
88,BHOPAL,PUNE,12,11,23
89,BHOPAL,RAIPUR,19,17,36
90,BHAVNAGAR,MUMBAI,20,21,41
91,BHAVNAGAR,PUNE,11,12,23
92,BIKANER,DELHI,12,13,25
93,BENGALURU,BHOPAL,37,41,78
94,BENGALURU,BHUBANESWAR,166,191,357
95,BENGALURU,"BIDAR AIRPORT, KARNATAKA",7,7,14
96,BAGDOGRA,GUWAHATI,1,1,2
97,BENGALURU,CHANDIGARH,146,137,283
98,BENGALURU,CHENNAI,288,302,590
99,BENGALURU,COIMBATORE,111,123,234
100,BENGALURU,DABOLIM,356,364,720
101,BENGALURU,DARBHANGA,44,47,91
102,BENGALURU,DEHRA DUN,44,43,87
103,BENGALURU,DELHI,1571,1589,3160
104,BENGALURU,DIMAPUR,11,7,18
105,BENGALURU,DURGAPUR,38,47,85
106,BENGALURU,GORAKHPUR,12,11,23
107,BENGALURU,GUWAHATI,127,165,292
108,BENGALURU,GWALIOR,22,21,43
109,BENGALURU,HUBLI,45,45,90
110,BENGALURU,HYDERABAD,556,578,1134
111,BENGALURU,IMPHAL,5,6,11
112,BENGALURU,INDORE,125,129,254
113,BENGALURU,JABALPUR,17,18,35
114,BENGALURU,JAIPUR,191,197,388
115,BENGALURU,JAMMU,5,5,10
116,BENGALURU,JAMNAGAR,5,5,10
117,BENGALURU,JHARSUGUDA,2,3,5
118,BENGALURU,JODHPUR,27,29,56
119,BENGALURU,JORHAT,8,6,14
120,BENGALURU,KADAPA,3,4,7
121,BENGALURU,"KALABURAGI, KARNATAKA",28,26,54
122,BENGALURU,KANNUR,36,40,76
123,BENGALURU,KANPUR,20,21,41
124,BENGALURU,KOCHI,469,451,920
125,BENGALURU,KOLHAPUR,7,6,13
126,BENGALURU,KOLKATA,584,621,1205
127,BENGALURU,KOZHIKODE,41,42,83
128,BENGALURU,KURNOOL,4,5,9
129,BENGALURU,LUCKNOW,177,208,385
130,BENGALURU,MADURAI,56,59,115
131,BENGALURU,MANGALORE,185,177,362
132,BENGALURU,MUMBAI,1229,1202,2431
133,BENGALURU,MYSORE,4,8,12
134,BENGALURU,NAGPUR,112,111,223
135,BENGALURU,PATNA,153,168,321
136,BENGALURU,PONDICHERRY,11,12,23
137,BENGALURU,PORT BLAIR,47,41,88
138,BENGALURU,PUNE,511,524,1035
139,BENGALURU,RAIPUR,91,91,182
140,BENGALURU,RAJAHMUNDRY,32,37,69
141,BENGALURU,RAJKOT,39,40,79
142,BENGALURU,RANCHI,126,152,278
143,BENGALURU,SHIRDI,58,58,116
144,BENGALURU,SRINAGAR,11,13,24
145,BENGALURU,SURAT,48,47,95
146,BENGALURU,TIRUCHIRAPALLY,38,35,73
147,BENGALURU,TIRUPATI,21,22,43
148,BENGALURU,TRIVANDRUM,144,146,290
149,BENGALURU,TUTICORIN,20,18,38
150,BENGALURU,UDAIPUR,19,18,37
151,BENGALURU,VADODARA,52,50,102
152,BENGALURU,VARANASI,87,101,188
153,BENGALURU,VIJAYAWADA,83,92,175
154,BENGALURU,VISAKHAPATNAM,159,186,345
155,MUMBAI,NAGPUR,267,285,552
156,MUMBAI,PATNA,143,164,307
157,MUMBAI,PORBANDAR,9,8,17
159,MUMBAI,RAIPUR,142,145,287
160,MUMBAI,RAJKOT,120,126,246
161,MUMBAI,RANCHI,104,123,227
162,MUMBAI,SILCHAR,1,1,2
163,MUMBAI,SRINAGAR,91,172,263
164,MUMBAI,SURAT,15,17,32
165,MUMBAI,TIRUPATI,11,8,19
166,MUMBAI,TRIVANDRUM,118,135,253
167,MUMBAI,UDAIPUR,171,181,352
168,MUMBAI,VADODARA,151,162,313
169,MUMBAI,VARANASI,181,187,368
170,MUMBAI,VISAKHAPATNAM,62,79,141
171,MUMBAI,Sindhudurg Airport,16,16,32
172,KOZHIKODE,MUMBAI,68,63,131
173,KOLKATA,LILABARI,9,9,18
174,KOLKATA,LUCKNOW,77,74,151
175,KOLKATA,MANGALORE,4,4,8
176,KOLKATA,MUMBAI,609,562,1171
177,KOLKATA,NAGPUR,33,31,64
179,KOLKATA,PATNA,75,87,162
180,KOLKATA,PORT BLAIR,135,111,246
181,KOLKATA,PUNE,111,105,216
182,KOLKATA,RAIPUR,78,77,155
183,KOLKATA,RANCHI,52,52,104
184,KOLKATA,RUPSI,10,11,21
185,KOLKATA,SHILLONG,15,14,29
186,KOLKATA,SILCHAR,72,81,153
187,KOLKATA,SRINAGAR,11,11,22
188,KOLKATA,SURAT,54,47,101
190,KOLKATA,TRIVANDRUM,7,4,11
191,KOLKATA,UDAIPUR,6,4,10
192,KOLKATA,VARANASI,37,47,84
193,KOLKATA,VISAKHAPATNAM,43,43,86
194,KADAPA,VIJAYAWADA,3,2,5
195,KADAPA,VISAKHAPATNAM,6,5,11
196,COIMBATORE,DELHI,139,139,278
197,COIMBATORE,GUWAHATI,4,2,6
198,COIMBATORE,HYDERABAD,161,158,319
199,COIMBATORE,JAIPUR,5,4,9
201,COIMBATORE,MUMBAI,173,163,336
203,COIMBATORE,SURAT,7,7,14
204,COIMBATORE,TIRUPATI,4,6,10
206,KANNUR,KOCHI,19,18,37
207,KANNUR,KOZHIKODE,1,1,2
208,KANNUR,MUMBAI,47,54,101
209,KANNUR,TRIVANDRUM,17,18,35
210,KOCHI,KOLKATA,22,28,50
211,KOCHI,MUMBAI,311,275,586
212,KOCHI,MYSORE,8,8,16
213,KOCHI,PUNE,43,41,84
214,KOCHI,RANCHI,3,3,6
215,KOCHI,TRIVANDRUM,19,19,38
216,DARBHANGA,DELHI,52,49,101
217,DARBHANGA,HYDERABAD,39,30,69
218,DARBHANGA,KOLKATA,20,15,35
219,DARBHANGA,MUMBAI,44,37,81
220,DEHRA DUN,DELHI,212,207,419
221,DEHRA DUN,GUWAHATI,6,1,7
222,DEHRA DUN,HYDERABAD,34,33,67
223,DEHRA DUN,JAIPUR,26,19,45
224,DEHRA DUN,KOLKATA,14,13,27
225,DEHRA DUN,LUCKNOW,27,31,58
226,DEHRA DUN,MUMBAI,88,103,191
227,DEHRA DUN,PANTNAGAR,7,8,15
228,DEHRA DUN,PUNE,9,10,19
229,DEHRA DUN,VARANASI,9,10,19
230,DELHI,DHARAMSALA,51,43,94
231,DELHI,DIBRUGARH,80,77,157
232,DELHI,DIMAPUR,24,26,50
233,DELHI,DURGAPUR,39,46,85
234,DELHI,GAYA,31,34,65
235,DELHI,GORAKHPUR,92,105,197
236,DELHI,GUWAHATI,494,505,999
237,DELHI,GWALIOR,20,22,42
238,DELHI,HYDERABAD,971,1051,2022
239,DELHI,IMPHAL,77,80,157
240,DELHI,INDORE,249,245,494
241,DELHI,JABALPUR,57,55,112
242,DELHI,JAGDALPUR,3,3,6
243,DELHI,JAIPUR,229,201,430
244,DELHI,JAMMU,284,306,590
245,DELHI,JHARSUGUDA,28,29,57
246,DELHI,JODHPUR,71,70,141
247,DELHI,JORHAT,7,7,14
248,DELHI,KANDLA,11,11,22
249,DELHI,KANNUR,11,15,26
250,DELHI,KANPUR,15,16,31
251,DELHI,KHAJURAHO,5,5,10
252,DELHI,KOCHI,322,318,640
253,DELHI,KOLKATA,902,922,1824
254,DELHI,KOZHIKODE,75,77,152
255,DELHI,KULLU,8,3,11
256,DELHI,LEH,479,499,978
257,DELHI,LUCKNOW,448,493,941
258,DELHI,MADURAI,31,30,61
259,DELHI,MANGALORE,21,17,38
260,DELHI,MUMBAI,1940,1854,3794
261,DELHI,NAGPUR,181,176,357
262,DELHI,NASIK,31,31,62
263,DELHI,PANTNAGAR,17,18,35
264,DELHI,PATHANKOT,6,6,12
265,DELHI,PATNA,533,545,1078
266,DELHI,PORBANDAR,1,1,2
267,DELHI,PORT BLAIR,36,32,68
268,DELHI,PUNE,920,855,1775
269,DELHI,RAIPUR,249,251,500
270,DELHI,RAJKOT,112,113,225
271,DELHI,RANCHI,279,287,566
272,DELHI,SHIRDI,91,88,179
273,DELHI,SILCHAR,18,19,37
274,DELHI,SRINAGAR,884,966,1850
275,DELHI,SURAT,165,161,326
276,DELHI,TIRUCHIRAPALLY,12,10,22
277,DELHI,TIRUPATI,29,22,51
278,DELHI,TRIVANDRUM,88,90,178
279,DELHI,UDAIPUR,150,157,307
280,DELHI,VADODARA,142,144,286
281,DELHI,VARANASI,218,223,441
282,DELHI,VIJAYAWADA,84,92,176
283,DELHI,VISAKHAPATNAM,152,174,326
284,DELHI,Kushinagar International Airport,6,7,13
286,DIBRUGARH,DIMAPUR,2,1,3
287,DIBRUGARH,GUWAHATI,17,12,29
289,DIBRUGARH,IMPHAL,7,8,15
290,DIBRUGARH,KOLKATA,91,82,173
291,DIBRUGARH,MUMBAI,3,6,9
292,DIBRUGARH,SHILLONG,2,2,4
293,DIU,MUMBAI,17,16,33
294,DIMAPUR,GUWAHATI,9,8,17
295,DIMAPUR,IMPHAL,10,11,21
296,DIMAPUR,KOLKATA,51,41,92
297,DIMAPUR,MUMBAI,2,2,4
298,DIMAPUR,SHILLONG,3,4,7
299,GUWAHATI,HYDERABAD,53,48,101
300,GUWAHATI,IMPHAL,140,162,302
301,GUWAHATI,JAIPUR,41,41,82
302,GUWAHATI,JODHPUR,1,2,3
303,GUWAHATI,JORHAT,13,17,30
304,GUWAHATI,KOLKATA,274,287,561
305,GUWAHATI,LUCKNOW,31,23,54
306,GUWAHATI,MUMBAI,123,97,220
307,GUWAHATI,PASIGHAT,4,4,8
308,GUWAHATI,PATNA,36,41,77
310,GUWAHATI,RUPSI,7,6,13
311,GUWAHATI,SHILLONG,2,1,3
312,GUWAHATI,SILCHAR,27,30,57
313,GUWAHATI,TEZPUR,2,1,3
314,GUWAHATI,TEZU,4,5,9
315,GUWAHATI,VARANASI,2,3,5
316,GAYA,KOLKATA,11,11,22
317,"KALABURAGI, KARNATAKA",TIRUPATI,4,3,7
318,Gondia Airport,HYDERABAD,2,3,5
319,Gondia Airport,INDORE,3,3,6
320,DABOLIM,DELHI,661,653,1314
322,DABOLIM,HYDERABAD,280,277,557
323,DABOLIM,INDORE,31,30,61
324,DABOLIM,JAIPUR,18,19,37
325,DABOLIM,KOLKATA,51,58,109
326,DABOLIM,LUCKNOW,62,66,128
327,DABOLIM,MUMBAI,703,698,1401
328,DABOLIM,MYSORE,12,12,24
330,DABOLIM,PUNE,80,74,154
331,DABOLIM,RAIPUR,11,12,23
332,DABOLIM,RAJKOT,15,15,30
333,DABOLIM,SURAT,45,44,89
334,GORAKHPUR,HYDERABAD,31,30,61
335,DELHI,PAKYONG,7,6,13
336,GORAKHPUR,KOLKATA,20,17,37
337,GORAKHPUR,LUCKNOW,5,4,9
338,GORAKHPUR,MUMBAI,64,59,123
339,GORAKHPUR,VARANASI,3,1,4
340,GWALIOR,HYDERABAD,3,3,6
341,GWALIOR,INDORE,16,17,33
342,GWALIOR,KOLKATA,11,11,22
343,GWALIOR,MUMBAI,4,4,8
344,HUBLI,HYDERABAD,18,17,35
345,HUBLI,MANGALORE,4,4,8
346,HUBLI,MUMBAI,19,19,38
347,HUBLI,MYSORE,4,3,7
348,HYDERABAD,IMPHAL,3,4,7
349,HYDERABAD,INDORE,98,106,204
350,HYDERABAD,JABALPUR,18,19,37
351,HYDERABAD,JAGDALPUR,12,12,24
352,HYDERABAD,JAIPUR,155,142,297
354,HYDERABAD,JAMNAGAR,5,5,10
355,HYDERABAD,JHARSUGUDA,3,3,6
356,HYDERABAD,JODHPUR,18,17,35
357,HYDERABAD,KADAPA,15,14,29
358,HYDERABAD,KANNUR,18,17,35
359,HYDERABAD,KOCHI,166,144,310
360,HYDERABAD,KOLHAPUR,29,27,56
361,HYDERABAD,KOLKATA,297,289,586
362,HYDERABAD,KOZHIKODE,20,18,38
363,HYDERABAD,LUCKNOW,74,78,152
364,HYDERABAD,MADURAI,47,45,92
365,HYDERABAD,MANGALORE,38,37,75
366,HYDERABAD,MUMBAI,683,596,1279
367,HYDERABAD,MYSORE,29,25,54
368,HYDERABAD,NAGPUR,20,21,41
369,HYDERABAD,NASIK,19,18,37
370,DIU,PUNE,1,1,2
371,HYDERABAD,PATNA,64,72,136
372,HYDERABAD,PONDICHERRY,23,22,45
373,HYDERABAD,PUNE,185,180,365
375,HYDERABAD,RAIPUR,71,78,149
376,HYDERABAD,RAJAHMUNDRY,97,100,197
377,HYDERABAD,RANCHI,41,43,84
378,HYDERABAD,SHIRDI,61,66,127
379,HYDERABAD,SRINAGAR,28,31,59
380,HYDERABAD,SURAT,36,46,82
381,HYDERABAD,TIRUCHIRAPALLY,36,31,67
382,HYDERABAD,TIRUPATI,220,226,446
383,HYDERABAD,TRIVANDRUM,53,46,99
384,HYDERABAD,UDAIPUR,28,30,58
385,HYDERABAD,VADODARA,51,50,101
386,HYDERABAD,VARANASI,83,93,176
387,HYDERABAD,VIJAYAWADA,110,109,219
388,HYDERABAD,VISAKHAPATNAM,287,287,574
389,INDORE,JABALPUR,10,11,21
390,INDORE,JAIPUR,21,20,41
391,INDORE,JAMMU,11,10,21
392,INDORE,KOLKATA,35,30,65
393,INDORE,LUCKNOW,16,19,35
394,INDORE,MUMBAI,225,213,438
395,INDORE,NAGPUR,19,19,38
396,INDORE,PUNE,41,42,83
397,INDORE,RAIPUR,36,31,67
398,IMPHAL,KOLKATA,123,110,233
399,IMPHAL,MUMBAI,5,3,8
400,IMPHAL,SHILLONG,8,8,16
401,NASIK,PUNE,8,8,16
402,AGARTALA,AHMEDABAD,3,4,7
403,AGARTALA,AIZAWL,4,4,8
405,AGARTALA,BENGALURU,45,43,88
406,AGARTALA,CHENNAI,20,17,37
407,AGARTALA,DELHI,45,39,84
408,AGARTALA,DIBRUGARH,10,12,22
409,AGARTALA,GUWAHATI,47,51,98
410,AGARTALA,IMPHAL,10,15,25
411,AGARTALA,KOLKATA,335,294,629
412,AGARTALA,SHILLONG,8,7,15
413,BAGDOGRA,BENGALURU,143,123,266
414,BAGDOGRA,CHENNAI,54,47,101
415,BAGDOGRA,DELHI,357,340,697
416,BAGDOGRA,DIBRUGARH,35,25,60
417,BAGDOGRA,HYDERABAD,50,51,101
418,BAGDOGRA,KOLKATA,224,187,411
419,BAGDOGRA,MUMBAI,67,49,116
420,CHANDIGARH,CHENNAI,35,39,74
421,CHANDIGARH,DABOLIM,61,65,126
423,CHANDIGARH,DELHI,271,282,553
425,CHANDIGARH,DHARAMSALA,9,9,18
426,CHANDIGARH,GUWAHATI,12,13,25
427,CHANDIGARH,HYDERABAD,67,79,146
428,CHANDIGARH,JAIPUR,34,28,62
429,CHANDIGARH,KOLKATA,19,31,50
430,CHANDIGARH,KULLU,4,1,5
431,CHANDIGARH,LEH,5,13,18
432,CHANDIGARH,LUCKNOW,25,27,52
433,CHANDIGARH,MUMBAI,265,255,520
434,CHANDIGARH,PATNA,23,27,50
435,CHANDIGARH,PUNE,43,38,81
436,CHANDIGARH,SRINAGAR,85,96,181
438,ALLAHABAD,BENGALURU,15,15,30
439,ALLAHABAD,BHOPAL,6,6,12
440,ALLAHABAD,BHUBANESWAR,12,14,26
441,ALLAHABAD,BILASPUR,5,3,8
442,ALLAHABAD,DEHRA DUN,10,11,21
443,ALLAHABAD,DELHI,47,43,90
444,ALLAHABAD,GORAKHPUR,7,7,14
445,ALLAHABAD,INDORE,17,15,32
446,ALLAHABAD,LUCKNOW,10,8,18
447,ALLAHABAD,MUMBAI,30,30,60
448,ALLAHABAD,PUNE,18,17,35
449,ALLAHABAD,RAIPUR,16,16,32
450,MANGALORE,MUMBAI,202,198,400
452,BELGAUM,BENGALURU,21,20,41
453,BELGAUM,DELHI,23,23,46
454,BELGAUM,HYDERABAD,23,23,46
455,BELGAUM,INDORE,3,4,7
456,BELGAUM,JODHPUR,3,3,6
457,BELGAUM,MUMBAI,24,24,48
458,BELGAUM,NAGPUR,3,3,6
459,BELGAUM,NASIK,4,3,7
460,BELGAUM,PUNE,7,7,14
461,BELGAUM,SURAT,4,4,8
462,BELGAUM,TIRUPATI,3,3,6
463,JAMMU,LEH,18,24,42
464,JAMMU,MUMBAI,19,63,82
465,JAMMU,SRINAGAR,155,137,292
467,LEH,SRINAGAR,87,9,96
468,MADURAI,MUMBAI,66,65,131
469,MADURAI,TIRUPATI,9,8,17
470,MADURAI,VIJAYAWADA,2,1,3
471,PASIGHAT,TEZPUR,1,1,2
472,AURANGABAD,DELHI,53,51,104
473,AURANGABAD,HYDERABAD,22,21,43
474,AURANGABAD,MUMBAI,76,70,146
475,KANDLA,MUMBAI,22,23,45
476,PORT BLAIR,VISAKHAPATNAM,14,15,29
477,JAIPUR,KOLKATA,110,129,239
478,JAIPUR,LUCKNOW,18,16,34
479,JAIPUR,MUMBAI,314,320,634
480,JAIPUR,PATNA,1,1,2
481,JAIPUR,PUNE,101,86,187
482,JAIPUR,SURAT,30,30,60
483,JAIPUR,UDAIPUR,16,21,37
484,JHARSUGUDA,MUMBAI,2,3,5
485,JAIPUR,VADODARA,2,2,4
486,JAIPUR,VARANASI,8,8,16
487,JODHPUR,KOLKATA,13,11,24
488,JODHPUR,MUMBAI,72,77,149
489,JAMNAGAR,MUMBAI,30,34,64
490,JAGDALPUR,RAIPUR,12,13,25
491,JABALPUR,KOLKATA,7,7,14
492,JABALPUR,MUMBAI,34,30,64
493,JABALPUR,PUNE,15,14,29
494,JHARSUGUDA,KOLKATA,12,12,24
495,JHARSUGUDA,RAIPUR,8,6,14
496,JORHAT,KOLKATA,34,35,69
497,KURNOOL,VISAKHAPATNAM,7,8,15
498,KOLHAPUR,TIRUPATI,14,18,32
500,KANPUR,MUMBAI,54,56,110
501,AJMER,DELHI,14,14,28
502,AJMER,HYDERABAD,1,1,2
503,AJMER,INDORE,3,3,6
504,AJMER,MUMBAI,2,2,4
505,AJMER,SURAT,3,4,7
506,LUCKNOW,MUMBAI,230,216,446
507,LUCKNOW,NAGPUR,13,12,25
508,LUCKNOW,PANTNAGAR,6,6,12
509,LUCKNOW,PATNA,28,36,64
510,LUCKNOW,PUNE,37,27,64
511,KOLKATA,PAKYONG,4,3,7
512,LUCKNOW,RAIPUR,9,11,20
513,LUCKNOW,RANCHI,24,28,52
514,LUCKNOW,SRINAGAR,5,8,13
515,CHENNAI,COIMBATORE,314,298,612
516,CHENNAI,DABOLIM,43,44,87
517,CHENNAI,DARBHANGA,5,3,8
518,CHENNAI,DEHRA DUN,7,8,15
519,CHENNAI,DELHI,778,748,1526
520,CHENNAI,DIBRUGARH,3,4,7
521,CHENNAI,DURGAPUR,29,36,65
523,CHENNAI,GUWAHATI,94,115,209
524,CHENNAI,HUBLI,16,16,32
525,CHENNAI,HYDERABAD,367,377,744
526,CHENNAI,INDORE,13,14,27
527,CHENNAI,JAIPUR,45,41,86
528,CHENNAI,JODHPUR,45,47,92
529,CHENNAI,KADAPA,4,3,7
530,CHENNAI,KANNUR,20,17,37
531,CHENNAI,KOCHI,171,158,329
532,CHENNAI,KOLKATA,313,339,652
533,CHENNAI,KOZHIKODE,19,18,37
534,CHENNAI,KURNOOL,4,5,9
535,CHENNAI,LUCKNOW,40,39,79
536,CHENNAI,MADURAI,131,133,264
537,CHENNAI,MANGALORE,20,19,39
538,CHENNAI,MUMBAI,734,702,1436
539,CHENNAI,MYSORE,20,17,37
540,CHENNAI,PATNA,17,20,37
541,CHENNAI,PORT BLAIR,137,151,288
542,CHENNAI,PUNE,192,204,396
543,CHENNAI,RAIPUR,26,26,52
544,CHENNAI,RAJAHMUNDRY,24,27,51
545,CHENNAI,RANCHI,25,35,60
546,CHENNAI,SHIRDI,64,62,126
547,CHENNAI,SRINAGAR,6,6,12
548,CHENNAI,SURAT,36,33,69
549,CHENNAI,TIRUCHIRAPALLY,75,71,146
550,CHENNAI,TRIVANDRUM,136,142,278
551,CHENNAI,TUTICORIN,67,65,132
552,CHENNAI,VADODARA,7,7,14
553,CHENNAI,VARANASI,25,22,47
554,CHENNAI,VIJAYAWADA,41,49,90
555,CHENNAI,VISAKHAPATNAM,89,110,199
556,NAGPUR,PUNE,126,120,246
557,BILASPUR,DELHI,3,4,7
558,BILASPUR,JABALPUR,3,4,7
559,PATNA,PUNE,48,40,88
560,PATNA,RANCHI,37,31,68
561,PATNA,VARANASI,1,1,2
562,PUNE,RAIPUR,20,20,40
563,PUNE,RANCHI,41,45,86
564,PUNE,TIRUPATI,9,9,18
565,DURGAPUR,HYDERABAD,25,19,44
566,DURGAPUR,MUMBAI,34,26,60
568,DURGAPUR,TRIVANDRUM,1,1,2
570,RAJAHMUNDRY,TIRUPATI,7,6,13
571,RAJAHMUNDRY,VISAKHAPATNAM,5,5,10
572,RAIPUR,SRINAGAR,3,5,8
575,SHIRDI,TIRUPATI,7,7,14
577,SHILLONG,SILCHAR,3,4,7
578,TIRUPATI,VIJAYAWADA,11,10,21
579,TIRUPATI,VISAKHAPATNAM,20,20,40
580,GHAZIABAD,HUBLI,8,7,15
581,GHAZIABAD,"KALABURAGI, KARNATAKA",3,4,7
582,VIJAYAWADA,VISAKHAPATNAM,18,19,37
583,Deoghar Airport,KOLKATA,7,7,14
584,Deoghar Airport,DELHI,36,34,70
