S.No.,CITY 1,CITY 2,AVG FLIGHTS TO CITY 2,AVG FLIGHTS FROM CITY 2,TOTAL AVG FLIGHTS
1,AGARTALA,AHMEDABAD,19,3,22
2,AGARTALA,AIZAWL,2,2,4
3,AGARTALA,BENGALURU,14,14,28
4,AGARTALA,CHENNAI,19,3,22
5,AGARTALA,DELHI,46,42,88
6,AGARTALA,DIBRUGARH,7,8,15
7,AGARTALA,GUWAHATI,38,37,75
8,AGARTALA,IMPHAL,6,6,12
9,AGARTALA,KOLKATA,225,194,419
10,AGARTALA,LUCKNOW,19,1,20
11,AGARTALA,MUMBAI,19,1,20
12,AGARTALA,SHILLONG,5,4,9
13,AGATTI ISLAND,BENGALURU,1,1,2
14,AGATTI ISLAND,KOCHI,11,16,27
15,AGATTI ISLAND,MYSORE,1,1,2
16,AGRA,BENGALURU,17,17,34
17,AGRA,BHOPAL,3,5,8
18,AGRA,LUCKNOW,4,3,7
19,AHMEDABAD,BAGDOGRA,28,30,58
20,AHMEDABAD,BELGAUM,6,7,13
21,AHMEDABAD,BENGALURU,237,229,466
22,AHMEDABAD,BHOPAL,17,19,36
23,AHMEDABAD,CHANDIGARH,64,59,123
24,AHMEDABAD,CHENNAI,80,76,156
25,AHMEDABAD,COIMBATORE,19,2,21
26,AHMEDABAD,DABOLIM,116,118,234
27,AHMEDABAD,DEHRA DUN,22,21,43
28,AHMEDABAD,DELHI,598,522,1120
29,AHMEDABAD,GWALIOR,15,14,29
30,AHMEDABAD,HYDERABAD,123,121,244
31,AHMEDABAD,INDORE,14,14,28
32,AHMEDABAD,JAIPUR,29,27,56
33,AHMEDABAD,JAISALMER,1,19,20
34,AHMEDABAD,JALGAON,1,1,2
35,AHMEDABAD,KOCHI,7,6,13
36,AHMEDABAD,KOLKATA,141,139,280
37,AHMEDABAD,LUCKNOW,67,55,122
38,AHMEDABAD,MUMBAI,345,342,687
39,AHMEDABAD,NAGPUR,18,17,35
40,AHMEDABAD,NASIK,6,6,12
41,AHMEDABAD,PATNA,35,37,72
42,AHMEDABAD,PUNE,70,70,140
43,AHMEDABAD,UDAIPUR,5,6,11
44,AHMEDABAD,VARANASI,15,15,30
45,AIZAWL,DELHI,13,13,26
46,AIZAWL,GUWAHATI,24,15,39
47,AIZAWL,IMPHAL,4,4,8
48,AIZAWL,KOLKATA,36,28,64
49,AIZAWL,MUMBAI,1,1,2
50,AIZAWL,SHILLONG,2,2,4
51,AJMER,DELHI,14,16,30
52,AJMER,HYDERABAD,22,23,45
53,AJMER,INDORE,5,5,10
54,AJMER,JABALPUR,1,19,20
55,AJMER,MUMBAI,13,13,26
56,AJMER,SURAT,5,5,10
57,ALLAHABAD,BENGALURU,23,25,48
58,ALLAHABAD,BHOPAL,10,11,21
59,ALLAHABAD,BHUBANESWAR,5,7,12
60,ALLAHABAD,BILASPUR,4,5,9
61,ALLAHABAD,DEHRA DUN,9,7,16
62,ALLAHABAD,DELHI,30,30,60
63,ALLAHABAD,GORAKHPUR,6,5,11
64,ALLAHABAD,INDORE,6,7,13
65,ALLAHABAD,MUMBAI,25,25,50
66,ALLAHABAD,PUNE,16,16,32
67,ALLAHABAD,RAIPUR,8,8,16
68,AMRITSAR,BENGALURU,15,18,33
69,AMRITSAR,DELHI,267,283,550
70,AMRITSAR,GUWAHATI,4,4,8
71,AMRITSAR,HYDERABAD,2,4,6
72,AMRITSAR,JAIPUR,15,12,27
73,AMRITSAR,JAISALMER,19,1,20
74,AMRITSAR,JAMMU,19,3,22
75,AMRITSAR,KOLKATA,19,20,39
76,AMRITSAR,MUMBAI,96,100,196
77,AMRITSAR,NANDED,5,4,9
78,AMRITSAR,PATNA,12,11,23
79,AMRITSAR,SRINAGAR,33,37,70
80,AURANGABAD,DELHI,48,49,97
81,AURANGABAD,HYDERABAD,11,10,21
82,AURANGABAD,MUMBAI,40,39,79
83,BAGDOGRA,BENGALURU,97,77,174
84,BAGDOGRA,CHENNAI,15,14,29
85,BAGDOGRA,DELHI,328,286,614
86,BAGDOGRA,DIBRUGARH,22,28,50
87,BAGDOGRA,GUWAHATI,19,10,29
88,BAGDOGRA,HYDERABAD,43,49,92
89,BAGDOGRA,JAIPUR,22,24,46
90,BAGDOGRA,KOLKATA,245,230,475
91,BAGDOGRA,MUMBAI,39,45,84
92,BAGDOGRA,PATNA,19,1,20
93,BAREILLY,BENGALURU,15,15,30
94,BAREILLY,DELHI,11,9,20
95,BAREILLY,MUMBAI,22,22,44
96,BELGAUM,BENGALURU,18,18,36
97,BELGAUM,DELHI,9,8,17
98,BELGAUM,HYDERABAD,27,28,55
99,BELGAUM,INDORE,5,5,10
100,BELGAUM,JODHPUR,5,5,10
101,BELGAUM,MUMBAI,25,24,49
102,BELGAUM,NASIK,3,4,7
103,BELGAUM,PUNE,7,6,13
104,BELGAUM,SURAT,5,5,10
105,BELGAUM,TIRUPATI,2,2,4
106,BENGALURU,BHOPAL,18,23,41
107,BENGALURU,BHUBANESWAR,163,156,319
108,BENGALURU,"BIDAR AIRPORT, KARNATAKA",1,1,2
109,BENGALURU,CHANDIGARH,68,58,126
110,BENGALURU,CHENNAI,213,217,430
111,BENGALURU,COIMBATORE,67,63,130
112,BENGALURU,DABOLIM,238,211,449
113,BENGALURU,DARBHANGA,41,45,86
114,BENGALURU,DEHRA DUN,26,24,50
115,BENGALURU,DELHI,979,966,1945
116,BENGALURU,DIMAPUR,5,4,9
117,BENGALURU,DURGAPUR,17,18,35
118,BENGALURU,GORAKHPUR,10,9,19
119,BENGALURU,GUWAHATI,126,137,263
120,BENGALURU,GWALIOR,19,19,38
121,BENGALURU,HUBLI,23,26,49
122,BENGALURU,HYDERABAD,393,422,815
123,BENGALURU,IMPHAL,2,3,5
124,BENGALURU,INDORE,59,66,125
125,BENGALURU,JABALPUR,20,20,40
126,BENGALURU,JAIPUR,174,161,335
127,BENGALURU,JAMNAGAR,5,5,10
128,BENGALURU,JHARSUGUDA,6,9,15
129,BENGALURU,JODHPUR,22,25,47
130,BENGALURU,JORHAT,2,2,4
131,BENGALURU,"KALABURAGI, KARNATAKA",25,25,50
132,BENGALURU,KANNUR,16,19,35
133,BENGALURU,KANPUR,13,13,26
134,BENGALURU,KOCHI,224,245,469
135,BENGALURU,KOLHAPUR,5,5,10
136,BENGALURU,KOLKATA,410,465,875
137,BENGALURU,KOZHIKODE,12,17,29
138,BENGALURU,KURNOOL,2,3,5
139,BENGALURU,LUCKNOW,113,112,225
140,BENGALURU,MADURAI,34,34,68
141,BENGALURU,MANGALORE,125,140,265
142,BENGALURU,MUMBAI,694,692,1386
143,BENGALURU,MYSORE,3,7,10
144,BENGALURU,NAGPUR,55,53,108
145,BENGALURU,PATNA,159,167,326
146,BENGALURU,PORT BLAIR,50,41,91
147,BENGALURU,PUNE,263,264,527
148,BENGALURU,RAIPUR,31,42,73
149,BENGALURU,RAJAHMUNDRY,12,13,25
150,BENGALURU,RAJKOT,19,18,37
151,BENGALURU,RANCHI,98,114,212
152,BENGALURU,SHIRDI,26,25,51
153,BENGALURU,SRINAGAR,13,9,22
154,BENGALURU,SURAT,32,31,63
155,BENGALURU,TIRUCHIRAPALLY,14,11,25
156,BENGALURU,TIRUPATI,9,9,18
157,BENGALURU,TRIVANDRUM,46,43,89
158,BENGALURU,TUTICORIN,6,6,12
159,BENGALURU,UDAIPUR,27,27,54
160,BENGALURU,VADODARA,19,23,42
161,BENGALURU,VARANASI,75,70,145
162,BENGALURU,VIDYANAGAR,1,1,2
163,BENGALURU,VIJAYAWADA,40,43,83
164,BENGALURU,VISAKHAPATNAM,109,122,231
165,BHAVNAGAR,MUMBAI,14,14,28
166,BHOPAL,DELHI,122,117,239
167,BHOPAL,GWALIOR,19,1,20
168,BHOPAL,HYDERABAD,20,15,35
169,BHOPAL,KOCHI,2,3,5
170,BHOPAL,LUCKNOW,2,19,21
171,BHOPAL,MUMBAI,86,87,173
172,BHOPAL,PUNE,14,13,27
173,BHOPAL,RAIPUR,8,9,17
174,BHOPAL,SURAT,1,19,20
175,BHUBANESWAR,CHENNAI,22,22,44
176,BHUBANESWAR,DELHI,321,326,647
177,BHUBANESWAR,HYDERABAD,77,82,159
178,BHUBANESWAR,JAIPUR,16,14,30
179,BHUBANESWAR,JHARSUGUDA,11,11,22
180,BHUBANESWAR,KOLKATA,142,124,266
181,BHUBANESWAR,MUMBAI,129,131,260
182,BHUBANESWAR,PUNE,36,36,72
183,BHUBANESWAR,RAIPUR,4,1,5
184,BHUBANESWAR,RANCHI,4,5,9
185,BHUBANESWAR,SURAT,4,4,8
186,BHUBANESWAR,VARANASI,10,9,19
187,BHUJ,MUMBAI,9,10,19
188,BIKANER,DELHI,7,8,15
189,BILASPUR,DELHI,5,4,9
190,BILASPUR,JABALPUR,4,3,7
191,CHANDIGARH,DABOLIM,43,43,86
192,CHANDIGARH,DELHI,237,233,470
193,CHANDIGARH,DHARAMSALA,6,6,12
194,CHANDIGARH,GUWAHATI,5,7,12
195,CHANDIGARH,HYDERABAD,40,49,89
196,CHANDIGARH,JAIPUR,5,4,9
197,CHANDIGARH,KOLKATA,21,26,47
198,CHANDIGARH,KULLU,3,1,4
199,CHANDIGARH,LEH,17,14,31
200,CHANDIGARH,LUCKNOW,14,19,33
201,CHANDIGARH,MUMBAI,290,324,614
202,CHANDIGARH,PUNE,31,32,63
203,CHANDIGARH,SRINAGAR,63,63,126
204,CHENNAI,COIMBATORE,185,186,371
205,CHENNAI,DABOLIM,51,44,95
206,CHENNAI,DARBHANGA,3,1,4
207,CHENNAI,DEHRA DUN,3,2,5
208,CHENNAI,DELHI,676,614,1290
209,CHENNAI,DIBRUGARH,19,3,22
210,CHENNAI,DURGAPUR,16,16,32
211,CHENNAI,GORAKHPUR,1,19,20
212,CHENNAI,GUWAHATI,75,83,158
213,CHENNAI,HUBLI,8,8,16
214,CHENNAI,HYDERABAD,325,320,645
215,CHENNAI,INDORE,9,10,19
216,CHENNAI,JAIPUR,29,27,56
217,CHENNAI,JODHPUR,45,44,89
218,CHENNAI,KANNUR,10,10,20
219,CHENNAI,KOCHI,79,83,162
220,CHENNAI,KOLKATA,270,254,524
221,CHENNAI,KOZHIKODE,7,8,15
222,CHENNAI,KURNOOL,3,3,6
223,CHENNAI,LUCKNOW,17,17,34
224,CHENNAI,MADURAI,112,116,228
225,CHENNAI,MANGALORE,17,14,31
226,CHENNAI,MUMBAI,492,482,974
227,CHENNAI,MYSORE,5,6,11
228,CHENNAI,NAGPUR,1,19,20
229,CHENNAI,PATNA,19,28,47
230,CHENNAI,PORT BLAIR,126,121,247
231,CHENNAI,PUNE,106,113,219
232,CHENNAI,RAIPUR,17,19,36
233,CHENNAI,RAJAHMUNDRY,11,18,29
234,CHENNAI,RANCHI,33,41,74
235,CHENNAI,SHIRDI,24,25,49
236,CHENNAI,TIRUCHIRAPALLY,39,36,75
237,CHENNAI,TRIVANDRUM,39,39,78
238,CHENNAI,TUTICORIN,44,44,88
239,CHENNAI,VARANASI,37,32,69
240,CHENNAI,VIJAYAWADA,19,16,35
241,CHENNAI,VISAKHAPATNAM,49,62,111
242,COIMBATORE,DELHI,57,52,109
243,COIMBATORE,GUWAHATI,2,19,21
244,COIMBATORE,HYDERABAD,68,72,140
245,COIMBATORE,JAIPUR,4,2,6
246,COIMBATORE,KOCHI,3,19,22
247,COIMBATORE,MANGALORE,2,4,6
248,COIMBATORE,MUMBAI,122,126,248
249,DABOLIM,DELHI,648,681,1329
250,DABOLIM,HYDERABAD,270,282,552
251,DABOLIM,INDORE,30,33,63
252,DABOLIM,JAIPUR,12,13,25
253,DABOLIM,KANNUR,4,5,9
254,DABOLIM,KOCHI,19,1,20
255,DABOLIM,KOLKATA,49,53,102
256,DABOLIM,LUCKNOW,16,17,33
257,DABOLIM,MUMBAI,714,718,1432
258,DABOLIM,MYSORE,8,8,16
259,DABOLIM,PUNE,55,55,110
260,DABOLIM,RAIPUR,10,9,19
261,DABOLIM,RAJKOT,13,15,28
262,DABOLIM,SURAT,44,43,87
263,DARBHANGA,DELHI,78,71,149
264,DARBHANGA,HYDERABAD,24,24,48
265,DARBHANGA,KOLKATA,18,17,35
266,DARBHANGA,MUMBAI,43,43,86
267,DEHRA DUN,DELHI,183,187,370
268,DEHRA DUN,LUCKNOW,18,20,38
269,DEHRA DUN,MUMBAI,82,101,183
270,DEHRA DUN,PANTNAGAR,3,3,6
271,DELHI,DHARAMSALA,37,34,71
272,DELHI,DIBRUGARH,75,63,138
273,DELHI,DIMAPUR,20,24,44
274,DELHI,DURGAPUR,15,16,31
275,DELHI,GAYA,19,1,20
276,DELHI,GORAKHPUR,94,92,186
277,DELHI,GUWAHATI,430,457,887
278,DELHI,GWALIOR,5,6,11
279,DELHI,HYDERABAD,710,792,1502
280,DELHI,IMPHAL,58,63,121
281,DELHI,INDORE,230,242,472
282,DELHI,JABALPUR,31,32,63
283,DELHI,JAIPUR,168,143,311
284,DELHI,JAISALMER,33,32,65
285,DELHI,JAMMU,288,283,571
286,DELHI,JHARSUGUDA,29,29,58
287,DELHI,JODHPUR,98,97,195
288,DELHI,JORHAT,5,4,9
289,DELHI,KANDLA,18,18,36
290,DELHI,KANNUR,6,8,14
291,DELHI,KANPUR,16,16,32
292,DELHI,KHAJURAHO,3,3,6
293,DELHI,KOCHI,206,246,452
294,DELHI,KOLKATA,747,793,1540
295,DELHI,KOZHIKODE,57,65,122
296,DELHI,KULLU,7,2,9
297,DELHI,LEH,237,127,364
298,DELHI,LUCKNOW,324,333,657
299,DELHI,MUMBAI,1480,1514,2994
300,DELHI,NAGPUR,141,164,305
301,DELHI,NASIK,4,4,8
302,DELHI,PAKYONG,16,13,29
303,DELHI,PANTNAGAR,2,2,4
304,DELHI,PATHANKOT,4,4,8
305,DELHI,PATNA,590,593,1183
306,DELHI,PORT BLAIR,47,36,83
307,DELHI,PUNE,691,678,1369
308,DELHI,RAIPUR,210,231,441
309,DELHI,RAJKOT,73,78,151
310,DELHI,RANCHI,322,342,664
311,DELHI,SHIRDI,39,36,75
312,DELHI,SILCHAR,11,7,18
313,DELHI,SRINAGAR,810,766,1576
314,DELHI,SURAT,168,179,347
315,DELHI,TIRUPATI,21,12,33
316,DELHI,TRIVANDRUM,57,71,128
317,DELHI,UDAIPUR,180,169,349
318,DELHI,VADODARA,113,147,260
319,DELHI,VARANASI,265,252,517
320,DELHI,VIJAYAWADA,72,78,150
321,DELHI,VISAKHAPATNAM,125,141,266
322,DELHI,Kushinagar International Airport,14,14,28
323,DIBRUGARH,GUWAHATI,14,12,26
324,DIBRUGARH,KOLKATA,71,66,137
325,DIBRUGARH,MUMBAI,4,3,7
326,DIBRUGARH,SHILLONG,3,3,6
327,DIMAPUR,GUWAHATI,8,4,12
328,DIMAPUR,HYDERABAD,19,1,20
329,DIMAPUR,IMPHAL,9,9,18
330,DIMAPUR,KOLKATA,45,29,74
331,DIMAPUR,MUMBAI,1,1,2
332,DIMAPUR,SHILLONG,2,1,3
333,DIU,MUMBAI,13,11,24
334,DURGAPUR,HYDERABAD,24,22,46
335,DURGAPUR,MUMBAI,18,17,35
336,GAYA,KOLKATA,8,7,15
337,GHAZIABAD,HUBLI,7,7,14
338,GHAZIABAD,"KALABURAGI, KARNATAKA",4,5,9
339,GORAKHPUR,HYDERABAD,34,34,68
340,GORAKHPUR,KOLKATA,8,8,16
341,GORAKHPUR,LUCKNOW,5,4,9
342,GORAKHPUR,MUMBAI,66,72,138
343,GUWAHATI,HYDERABAD,40,39,79
344,GUWAHATI,IMPHAL,111,108,219
345,GUWAHATI,JAIPUR,38,38,76
346,GUWAHATI,JODHPUR,19,1,20
347,GUWAHATI,JORHAT,3,7,10
348,GUWAHATI,KOLKATA,236,231,467
349,GUWAHATI,LILABARI,6,7,13
350,GUWAHATI,LUCKNOW,21,20,41
351,GUWAHATI,MUMBAI,46,47,93
352,GUWAHATI,PASIGHAT,3,4,7
353,GUWAHATI,PATNA,16,15,31
354,GUWAHATI,PUNE,2,19,21
355,GUWAHATI,RUPSI,8,8,16
356,GUWAHATI,SHILLONG,1,1,2
357,GUWAHATI,SILCHAR,15,21,36
358,GUWAHATI,TEZPUR,1,1,2
359,GUWAHATI,TEZU,3,5,8
360,GWALIOR,HYDERABAD,10,12,22
361,GWALIOR,INDORE,6,7,13
362,GWALIOR,JAIPUR,1,1,2
363,GWALIOR,JAMMU,7,5,12
364,GWALIOR,KOLKATA,13,12,25
365,GWALIOR,MUMBAI,15,15,30
366,HUBLI,KANNUR,3,4,7
367,HUBLI,MUMBAI,10,10,20
368,HUBLI,TIRUPATI,2,2,4
369,HYDERABAD,IMPHAL,4,3,7
370,HYDERABAD,INDORE,54,58,112
371,HYDERABAD,JABALPUR,8,9,17
372,HYDERABAD,JAGDALPUR,9,9,18
373,HYDERABAD,JAIPUR,124,117,241
374,HYDERABAD,JAMNAGAR,5,4,9
375,HYDERABAD,JHARSUGUDA,17,17,34
376,HYDERABAD,JODHPUR,25,24,49
377,HYDERABAD,KANNUR,9,11,20
378,HYDERABAD,KOCHI,106,106,212
379,HYDERABAD,KOLHAPUR,22,20,42
380,HYDERABAD,KOLKATA,309,273,582
381,HYDERABAD,KOZHIKODE,8,8,16
382,HYDERABAD,LUCKNOW,79,72,151
383,HYDERABAD,MADURAI,25,24,49
384,HYDERABAD,MANGALORE,27,28,55
385,HYDERABAD,MUMBAI,422,392,814
386,HYDERABAD,MYSORE,17,15,32
387,HYDERABAD,NAGPUR,8,8,16
388,HYDERABAD,NANDED,2,2,4
389,HYDERABAD,PATNA,62,54,116
390,HYDERABAD,PORT BLAIR,9,10,19
391,HYDERABAD,PUNE,86,79,165
392,HYDERABAD,RAIPUR,63,72,135
393,HYDERABAD,RAJAHMUNDRY,60,63,123
394,HYDERABAD,RANCHI,35,39,74
395,HYDERABAD,SHIRDI,28,25,53
396,HYDERABAD,SRINAGAR,19,1,20
397,HYDERABAD,SURAT,34,27,61
398,HYDERABAD,TIRUCHIRAPALLY,18,16,34
399,HYDERABAD,TIRUPATI,194,200,394
400,HYDERABAD,TRIVANDRUM,35,27,62
401,HYDERABAD,UDAIPUR,25,25,50
402,HYDERABAD,VADODARA,25,25,50
403,HYDERABAD,VARANASI,69,64,133
404,HYDERABAD,VIDYANAGAR,1,1,2
405,HYDERABAD,VIJAYAWADA,71,74,145
406,HYDERABAD,VISAKHAPATNAM,231,225,456
407,IMPHAL,KOLKATA,109,95,204
408,IMPHAL,MUMBAI,3,4,7
409,IMPHAL,SHILLONG,8,6,14
410,INDORE,JABALPUR,6,6,12
411,INDORE,JAIPUR,8,8,16
412,INDORE,JODHPUR,10,9,19
413,INDORE,KOLKATA,32,27,59
414,INDORE,LUCKNOW,11,11,22
415,INDORE,MUMBAI,131,138,269
416,INDORE,NAGPUR,9,9,18
417,INDORE,PUNE,29,31,60
418,INDORE,RAIPUR,29,31,60
419,INDORE,SURAT,6,8,14
420,JABALPUR,MUMBAI,35,35,70
421,JABALPUR,PUNE,17,15,32
422,JAGDALPUR,RAIPUR,10,10,20
423,JAIPUR,JAISALMER,17,15,32
424,JAIPUR,KOLKATA,152,159,311
425,JAIPUR,LUCKNOW,9,9,18
426,JAIPUR,MUMBAI,383,405,788
427,JAIPUR,PORT BLAIR,1,19,20
428,JAIPUR,PUNE,62,57,119
429,JAIPUR,SURAT,19,20,39
430,JAIPUR,UDAIPUR,21,21,42
431,JAISALMER,MUMBAI,2,2,4
432,JALGAON,MUMBAI,2,1,3
433,JAMMU,LEH,33,36,69
434,JAMMU,MUMBAI,29,74,103
435,JAMMU,SRINAGAR,190,127,317
436,JAMNAGAR,MUMBAI,29,30,59
437,JHARSUGUDA,KOLKATA,23,22,45
438,JHARSUGUDA,RAIPUR,8,6,14
439,JODHPUR,KOLKATA,10,10,20
440,JODHPUR,MUMBAI,157,164,321
441,JORHAT,KOLKATA,18,18,36
442,JORHAT,NAGPUR,19,1,20
443,"KALABURAGI, KARNATAKA",TIRUPATI,4,3,7
444,KANDLA,MUMBAI,28,29,57
445,KANNUR,KOCHI,10,10,20
446,KANNUR,KOZHIKODE,1,1,2
447,KANNUR,MANGALORE,2,1,3
448,KANNUR,MUMBAI,14,13,27
449,KANNUR,TRIVANDRUM,10,9,19
450,KANPUR,MUMBAI,41,41,82
451,KOCHI,KOLKATA,43,40,83
452,KOCHI,MUMBAI,257,237,494
453,KOCHI,MYSORE,8,8,16
454,KOCHI,PUNE,20,20,40
455,KOCHI,RANCHI,4,2,6
456,KOCHI,TRIVANDRUM,7,7,14
457,KOCHI,VADODARA,1,19,20
458,KOLHAPUR,MUMBAI,2,2,4
459,KOLHAPUR,TIRUPATI,7,9,16
460,KOLKATA,LILABARI,8,10,18
461,KOLKATA,LUCKNOW,59,89,148
462,KOLKATA,MANGALORE,1,1,2
463,KOLKATA,MUMBAI,486,461,947
464,KOLKATA,NAGPUR,19,25,44
465,KOLKATA,PAKYONG,15,13,28
466,KOLKATA,PASIGHAT,19,1,20
467,KOLKATA,PATNA,58,61,119
468,KOLKATA,PORT BLAIR,134,118,252
469,KOLKATA,PUNE,58,55,113
470,KOLKATA,RAIPUR,39,47,86
471,KOLKATA,RANCHI,28,36,64
472,KOLKATA,RUPSI,12,12,24
473,KOLKATA,SHILLONG,13,13,26
474,KOLKATA,SILCHAR,93,94,187
475,KOLKATA,SRINAGAR,4,5,9
476,KOLKATA,SURAT,34,36,70
477,KOLKATA,TEZPUR,19,3,22
478,KOLKATA,UDAIPUR,3,3,6
479,KOLKATA,VARANASI,39,38,77
480,KOLKATA,VISAKHAPATNAM,30,36,66
481,KOZHIKODE,MUMBAI,24,24,48
482,KURNOOL,VISAKHAPATNAM,6,6,12
483,LEH,SRINAGAR,18,10,28
484,LUCKNOW,MUMBAI,207,229,436
485,LUCKNOW,NAGPUR,17,16,33
486,LUCKNOW,PATNA,26,25,51
487,LUCKNOW,PUNE,26,25,51
488,LUCKNOW,RAIPUR,16,18,34
489,LUCKNOW,RANCHI,21,25,46
490,LUCKNOW,VARANASI,3,1,4
491,MADURAI,MUMBAI,16,18,34
492,MADURAI,TIRUPATI,4,4,8
493,MADURAI,VIJAYAWADA,19,2,21
494,MANGALORE,MUMBAI,158,177,335
495,MUMBAI,NAGPUR,221,226,447
496,MUMBAI,NANDED,6,4,10
497,MUMBAI,PATNA,126,128,254
498,MUMBAI,PORT BLAIR,4,19,23
499,MUMBAI,PUNE,1,1,2
500,MUMBAI,RAIPUR,87,81,168
501,MUMBAI,RAJKOT,79,77,156
502,MUMBAI,RANCHI,97,115,212
503,MUMBAI,SILCHAR,1,19,20
504,MUMBAI,SRINAGAR,68,100,168
505,MUMBAI,SURAT,12,15,27
506,MUMBAI,TIRUPATI,10,7,17
507,MUMBAI,TRIVANDRUM,50,62,112
508,MUMBAI,UDAIPUR,204,196,400
509,MUMBAI,VADODARA,73,74,147
510,MUMBAI,VARANASI,222,205,427
511,MUMBAI,VISAKHAPATNAM,47,59,106
512,MUMBAI,Sindhudurg Airport,14,13,27
513,NAGPUR,PUNE,136,120,256
514,NAGPUR,RAIPUR,1,1,2
515,NASIK,PUNE,6,5,11
516,PASIGHAT,TEZPUR,1,1,2
517,PATNA,PUNE,29,29,58
518,PATNA,RANCHI,20,21,41
519,PATNA,VARANASI,1,19,20
520,PORT BLAIR,VISAKHAPATNAM,16,13,29
521,PUNE,RAIPUR,12,13,25
522,PUNE,TIRUPATI,7,8,15
523,RAIPUR,VISAKHAPATNAM,5,19,24
524,RAJAHMUNDRY,VISAKHAPATNAM,4,4,8
525,SHILLONG,SILCHAR,2,3,5
526,TIRUPATI,VIJAYAWADA,2,4,6
527,TIRUPATI,VISAKHAPATNAM,17,22,39
528,VIJAYAWADA,VISAKHAPATNAM,16,15,31
