S.No.,CITY 1,CITY 2,AVG FLIGHTS TO CITY 2,AVG FLIGHTS FROM CITY 2,TOTAL AVG FLIGHTS
1,AGRA,AHMEDABAD,6,8,14
2,AGRA,BENGALURU,25,24,49
3,AGRA,BHOPAL,2,2,4
4,AGRA,LUCKNOW,4,5,9
5,AGRA,MUMBAI,15,15,30
6,AGATTI ISLAND,BENGALURU,1,1,2
7,AGATTI ISLAND,KOCHI,11,16,27
8,AGATTI ISLAND,MYSORE,1,1,2
9,AIZAWL,DELHI,18,16,34
10,AIZAWL,GUWAHATI,37,32,69
11,AIZAWL,IMPHAL,8,7,15
12,AIZAWL,KOLKATA,54,45,99
13,AIZAWL,MUMBAI,1,1,2
14,AIZAWL,SHILLONG,2,2,4
15,AHMEDABAD,AMRITSAR,9,10,19
16,AHMEDABAD,BAGDOGRA,13,10,23
17,AHMEDABAD,BELGAUM,8,8,16
18,AHMEDABAD,BENGALURU,227,229,456
19,AHMEDABAD,BHOPAL,14,16,30
20,AHMEDABAD,BHUBANESWAR,12,13,25
21,AHMEDABAD,BHUJ,6,6,12
22,AHMEDABAD,CHANDIGARH,54,50,104
23,AHMEDABAD,CHENNAI,113,111,224
24,AHMEDABAD,COIMBATORE,11,7,18
25,AHMEDABAD,DABOLIM,115,126,241
26,AHMEDABAD,DEHRA DUN,46,52,98
27,AHMEDABAD,DELHI,555,561,1116
28,AHMEDABAD,DURGAPUR,2,3,5
29,AHMEDABAD,GUWAHATI,7,7,14
30,AHMEDABAD,GWALIOR,9,9,18
31,AHMEDABAD,HYDERABAD,116,111,227
32,AHMEDABAD,INDORE,19,20,39
33,AHMEDABAD,JAIPUR,50,51,101
34,AHMEDABAD,JODHPUR,15,13,28
35,AHMEDABAD,KOCHI,32,27,59
36,AHMEDABAD,KOLHAPUR,7,7,14
37,AHMEDABAD,KOLKATA,141,145,286
38,AHMEDABAD,LUCKNOW,63,67,130
39,AHMEDABAD,MUMBAI,431,403,834
40,AHMEDABAD,NAGPUR,26,27,53
41,AHMEDABAD,NASIK,6,6,12
42,AHMEDABAD,PATNA,46,48,94
43,AHMEDABAD,PUNE,117,118,235
44,AHMEDABAD,RAIPUR,19,19,38
45,AHMEDABAD,RANCHI,15,16,31
46,AHMEDABAD,SHIRDI,1,1,2
47,AHMEDABAD,TRIVANDRUM,1,1,2
48,AHMEDABAD,VARANASI,21,21,42
49,AHMEDABAD,VISAKHAPATNAM,5,4,9
50,AMRITSAR,BENGALURU,22,18,40
51,AMRITSAR,CHENNAI,1,2,3
52,AMRITSAR,DABOLIM,10,11,21
53,AMRITSAR,DEHRA DUN,1,21,22
54,AMRITSAR,DELHI,234,238,472
55,AMRITSAR,GUWAHATI,2,3,5
56,AMRITSAR,HYDERABAD,2,2,4
57,AMRITSAR,JAIPUR,5,4,9
58,AMRITSAR,JAMMU,22,2,24
59,AMRITSAR,KOLKATA,47,48,95
60,AMRITSAR,LUCKNOW,10,10,20
61,AMRITSAR,MUMBAI,83,70,153
62,AMRITSAR,PATNA,10,11,21
63,AMRITSAR,PUNE,28,33,61
64,AMRITSAR,SRINAGAR,81,86,167
65,BHUBANESWAR,CHANDIGARH,7,6,13
66,BHUBANESWAR,CHENNAI,74,74,148
67,BHUBANESWAR,DEHRA DUN,22,1,23
68,BHUBANESWAR,DELHI,317,306,623
69,BHUBANESWAR,HYDERABAD,127,104,231
70,BHUBANESWAR,JAIPUR,13,15,28
71,BHUBANESWAR,JHARSUGUDA,11,11,22
72,BHUBANESWAR,KOLKATA,156,158,314
73,BHUBANESWAR,LUCKNOW,2,2,4
74,BHUBANESWAR,MUMBAI,169,154,323
75,BHUBANESWAR,PATNA,27,26,53
76,BHUBANESWAR,PUNE,36,32,68
77,BHUBANESWAR,RAIPUR,8,7,15
78,BHUBANESWAR,RANCHI,4,5,9
79,BHUBANESWAR,VARANASI,14,15,29
80,BAREILLY,BENGALURU,26,22,48
81,BAREILLY,DELHI,11,9,20
82,BAREILLY,MUMBAI,17,17,34
83,BHUJ,MUMBAI,9,10,19
84,BHOPAL,CHENNAI,7,8,15
85,BHOPAL,DELHI,159,152,311
86,BHOPAL,HYDERABAD,23,22,45
87,BHOPAL,INDORE,22,1,23
88,BHOPAL,KOCHI,5,7,12
89,BHOPAL,LUCKNOW,2,21,23
90,BHOPAL,MUMBAI,110,102,212
91,BHOPAL,PUNE,13,11,24
92,BHOPAL,RAIPUR,15,15,30
93,BHAVNAGAR,MUMBAI,13,16,29
94,BHAVNAGAR,PUNE,8,8,16
95,BIKANER,DELHI,7,8,15
96,BENGALURU,BHOPAL,36,43,79
97,BENGALURU,BHUBANESWAR,173,207,380
98,BENGALURU,"BIDAR AIRPORT, KARNATAKA",7,8,15
99,BENGALURU,CHANDIGARH,152,148,300
100,BENGALURU,CHENNAI,273,291,564
101,BENGALURU,COIMBATORE,109,120,229
102,BENGALURU,DABOLIM,310,323,633
103,BENGALURU,DARBHANGA,65,69,134
104,BENGALURU,DEHRA DUN,58,65,123
105,BENGALURU,DELHI,1542,1580,3122
106,BENGALURU,DIMAPUR,11,8,19
107,BENGALURU,DURGAPUR,40,46,86
108,BENGALURU,GORAKHPUR,12,12,24
109,BENGALURU,GUWAHATI,145,145,290
110,BENGALURU,GWALIOR,22,22,44
111,BENGALURU,HUBLI,46,47,93
112,BENGALURU,HYDERABAD,528,530,1058
113,BENGALURU,IMPHAL,8,8,16
114,BENGALURU,INDORE,104,115,219
115,BENGALURU,JABALPUR,15,18,33
116,BENGALURU,JAIPUR,176,175,351
117,BENGALURU,JAMMU,9,10,19
118,BENGALURU,JAMNAGAR,4,4,8
119,BENGALURU,JHARSUGUDA,19,21,40
120,BENGALURU,JODHPUR,27,30,57
121,BENGALURU,JORHAT,7,7,14
122,BENGALURU,KADAPA,2,3,5
123,BENGALURU,"KALABURAGI, KARNATAKA",26,25,51
124,BENGALURU,KANNUR,34,40,74
125,BENGALURU,KANPUR,20,22,42
126,BENGALURU,KOCHI,333,371,704
127,BENGALURU,KOLHAPUR,5,5,10
128,BENGALURU,KOLKATA,621,611,1232
129,BENGALURU,KOZHIKODE,45,44,89
130,BENGALURU,KURNOOL,4,5,9
131,BENGALURU,LUCKNOW,145,177,322
132,BENGALURU,MADURAI,50,52,102
133,BENGALURU,MANGALORE,168,162,330
134,BENGALURU,MUMBAI,1026,1076,2102
135,BENGALURU,MYSORE,3,7,10
136,BENGALURU,NAGPUR,90,100,190
137,BENGALURU,PATNA,155,179,334
138,BENGALURU,PONDICHERRY,10,11,21
139,BENGALURU,PORT BLAIR,43,35,78
140,BENGALURU,PUNE,412,437,849
141,BENGALURU,RAIPUR,85,90,175
142,BENGALURU,RAJAHMUNDRY,32,33,65
143,BENGALURU,RAJKOT,35,39,74
144,BENGALURU,RANCHI,116,136,252
145,BENGALURU,SHIRDI,70,67,137
146,BENGALURU,SRINAGAR,20,18,38
147,BENGALURU,SURAT,48,46,94
148,BENGALURU,TIRUCHIRAPALLY,36,34,70
149,BENGALURU,TIRUPATI,21,21,42
150,BENGALURU,TRIVANDRUM,138,142,280
151,BENGALURU,TUTICORIN,19,18,37
152,BENGALURU,UDAIPUR,19,17,36
153,BENGALURU,VADODARA,51,47,98
154,BENGALURU,VARANASI,97,115,212
155,BENGALURU,VIJAYAWADA,81,87,168
156,BENGALURU,VISAKHAPATNAM,127,138,265
157,MUMBAI,NAGPUR,225,240,465
158,MUMBAI,PATNA,133,152,285
159,MUMBAI,PORBANDAR,14,11,25
160,MUMBAI,PORT BLAIR,1,21,22
161,MUMBAI,PUNE,1,1,2
162,MUMBAI,RAIPUR,120,122,242
163,MUMBAI,RAJKOT,112,105,217
164,MUMBAI,RANCHI,108,120,228
165,MUMBAI,SILCHAR,1,1,2
166,MUMBAI,SRINAGAR,150,230,380
167,MUMBAI,SURAT,15,17,32
168,MUMBAI,TIRUPATI,11,13,24
169,MUMBAI,TRIVANDRUM,106,87,193
170,MUMBAI,UDAIPUR,159,162,321
171,MUMBAI,VADODARA,139,151,290
172,MUMBAI,VARANASI,177,162,339
173,MUMBAI,VISAKHAPATNAM,64,63,127
174,MUMBAI,Sindhudurg Airport,14,13,27
175,KOZHIKODE,MUMBAI,57,63,120
176,KOLKATA,LILABARI,8,10,18
177,KOLKATA,LUCKNOW,80,80,160
178,KOLKATA,MANGALORE,4,4,8
179,KOLKATA,MUMBAI,535,551,1086
180,KOLKATA,NAGPUR,33,38,71
181,KOLKATA,PASIGHAT,22,1,23
182,KOLKATA,PATNA,85,95,180
183,KOLKATA,PORT BLAIR,121,105,226
184,KOLKATA,PUNE,101,108,209
185,KOLKATA,RAIPUR,66,80,146
186,KOLKATA,RANCHI,54,53,107
187,KOLKATA,RUPSI,12,12,24
188,KOLKATA,SHILLONG,13,12,25
189,KOLKATA,SILCHAR,88,87,175
190,KOLKATA,SRINAGAR,21,15,36
191,KOLKATA,SURAT,53,51,104
192,KOLKATA,TEZPUR,22,3,25
193,KOLKATA,TRIVANDRUM,5,1,6
194,KOLKATA,UDAIPUR,3,2,5
195,KOLKATA,VARANASI,39,48,87
196,KOLKATA,VISAKHAPATNAM,41,46,87
197,KADAPA,VIJAYAWADA,3,3,6
198,KADAPA,VISAKHAPATNAM,5,5,10
199,COIMBATORE,DELHI,137,127,264
200,COIMBATORE,GUWAHATI,5,3,8
201,COIMBATORE,HYDERABAD,148,146,294
202,COIMBATORE,JAIPUR,5,4,9
203,COIMBATORE,KOCHI,1,21,22
204,COIMBATORE,MANGALORE,2,13,15
205,COIMBATORE,MUMBAI,153,137,290
206,COIMBATORE,PUNE,43,38,81
207,COIMBATORE,SURAT,5,5,10
208,COIMBATORE,TIRUPATI,5,7,12
209,COIMBATORE,TRIVANDRUM,22,1,23
210,COIMBATORE,VISAKHAPATNAM,22,4,26
211,KANNUR,KOCHI,19,19,38
212,KANNUR,KOZHIKODE,1,1,2
213,KANNUR,MUMBAI,33,41,74
214,KANNUR,TRIVANDRUM,16,18,34
215,KOCHI,KOLKATA,22,25,47
216,KOCHI,MUMBAI,245,254,499
217,KOCHI,MYSORE,8,8,16
218,KOCHI,PUNE,44,38,82
219,KOCHI,RANCHI,3,3,6
220,KOCHI,TRIVANDRUM,18,17,35
221,DARBHANGA,DELHI,60,59,119
222,DARBHANGA,HYDERABAD,45,38,83
223,DARBHANGA,KOLKATA,27,22,49
224,DARBHANGA,MUMBAI,51,54,105
225,DEHRA DUN,DELHI,199,193,392
226,DEHRA DUN,GUWAHATI,3,2,5
227,DEHRA DUN,HYDERABAD,39,37,76
228,DEHRA DUN,JAIPUR,19,15,34
229,DEHRA DUN,KOLKATA,9,8,17
230,DEHRA DUN,LUCKNOW,29,35,64
231,DEHRA DUN,MUMBAI,84,97,181
232,DEHRA DUN,PANTNAGAR,5,6,11
233,DEHRA DUN,PUNE,7,10,17
234,DEHRA DUN,VARANASI,8,8,16
235,DELHI,DHARAMSALA,54,48,102
236,DELHI,DIBRUGARH,83,79,162
237,DELHI,DIMAPUR,25,27,52
238,DELHI,DURGAPUR,39,45,84
239,DELHI,GAYA,34,36,70
240,DELHI,GORAKHPUR,96,104,200
241,DELHI,GUWAHATI,543,555,1098
242,DELHI,GWALIOR,19,21,40
243,DELHI,HYDERABAD,985,969,1954
244,DELHI,IMPHAL,81,81,162
245,DELHI,INDORE,238,226,464
246,DELHI,JABALPUR,53,47,100
247,DELHI,JAGDALPUR,3,3,6
248,DELHI,JAIPUR,208,186,394
249,DELHI,JAMMU,267,308,575
250,DELHI,JHARSUGUDA,28,29,57
251,DELHI,JODHPUR,67,65,132
252,DELHI,JORHAT,10,10,20
253,DELHI,KANDLA,15,13,28
254,DELHI,KANNUR,19,13,32
255,DELHI,KANPUR,17,18,35
256,DELHI,KHAJURAHO,5,5,10
257,DELHI,KOCHI,317,321,638
258,DELHI,KOLKATA,939,884,1823
259,DELHI,KOZHIKODE,66,68,134
260,DELHI,KULLU,7,2,9
261,DELHI,LEH,532,589,1121
262,DELHI,LUCKNOW,380,399,779
263,DELHI,MADURAI,46,48,94
264,DELHI,MANGALORE,24,24,48
265,DELHI,MUMBAI,1719,1680,3399
266,DELHI,NAGPUR,163,163,326
267,DELHI,NASIK,4,4,8
268,DELHI,PANTNAGAR,14,17,31
269,DELHI,PATHANKOT,4,4,8
270,DELHI,PATNA,528,530,1058
271,DELHI,PORBANDAR,5,4,9
272,DELHI,PORT BLAIR,32,33,65
273,DELHI,PUNE,805,752,1557
274,DELHI,RAIPUR,247,256,503
275,DELHI,RAJKOT,86,89,175
276,DELHI,RANCHI,280,288,568
277,DELHI,SHIRDI,81,79,160
278,DELHI,SILCHAR,22,22,44
279,DELHI,SRINAGAR,1176,1190,2366
280,DELHI,SURAT,169,167,336
281,DELHI,TIRUCHIRAPALLY,10,9,19
282,DELHI,TIRUPATI,25,21,46
283,DELHI,TRIVANDRUM,119,118,237
284,DELHI,UDAIPUR,141,142,283
285,DELHI,VADODARA,140,143,283
286,DELHI,VARANASI,214,214,428
287,DELHI,VIJAYAWADA,92,91,183
288,DELHI,VISAKHAPATNAM,157,152,309
289,DELHI,Kushinagar International Airport,12,14,26
290,DHARAMSALA,JAIPUR,1,2,3
291,DIBRUGARH,DIMAPUR,2,1,3
292,DIBRUGARH,GUWAHATI,30,25,55
293,DIBRUGARH,IMPHAL,8,9,17
294,DIBRUGARH,KOLKATA,95,81,176
295,DIBRUGARH,MUMBAI,6,8,14
296,DIBRUGARH,SHILLONG,3,5,8
297,DIU,MUMBAI,13,11,24
298,DIMAPUR,GUWAHATI,8,4,12
299,DIMAPUR,IMPHAL,9,9,18
300,DIMAPUR,KOLKATA,56,42,98
301,DIMAPUR,MUMBAI,1,2,3
302,DIMAPUR,SHILLONG,2,1,3
303,GUWAHATI,HYDERABAD,46,45,91
304,GUWAHATI,IMPHAL,151,164,315
305,GUWAHATI,JAIPUR,68,64,132
306,GUWAHATI,JODHPUR,2,2,4
307,GUWAHATI,JORHAT,14,16,30
308,GUWAHATI,KOLKATA,325,336,661
309,GUWAHATI,LUCKNOW,34,29,63
310,GUWAHATI,MUMBAI,95,91,186
311,GUWAHATI,PASIGHAT,4,4,8
312,GUWAHATI,PATNA,38,41,79
313,GUWAHATI,PUNE,40,43,83
314,GUWAHATI,RUPSI,8,7,15
315,GUWAHATI,SHILLONG,1,1,2
316,GUWAHATI,SILCHAR,49,51,100
317,GUWAHATI,TEZPUR,1,1,2
318,GUWAHATI,TEZU,4,4,8
319,GUWAHATI,VARANASI,2,2,4
320,GAYA,KOLKATA,10,10,20
321,"KALABURAGI, KARNATAKA",TIRUPATI,3,2,5
322,Gondia Airport,HYDERABAD,5,6,11
323,Gondia Airport,INDORE,8,7,15
324,DABOLIM,DELHI,575,543,1118
325,DABOLIM,GUWAHATI,11,21,32
326,DABOLIM,HYDERABAD,297,277,574
327,DABOLIM,INDORE,32,31,63
328,DABOLIM,JAIPUR,14,15,29
329,DABOLIM,KOLKATA,53,58,111
330,DABOLIM,LUCKNOW,35,37,72
331,DABOLIM,MUMBAI,588,562,1150
332,DABOLIM,MYSORE,8,8,16
333,DABOLIM,NAGPUR,26,25,51
334,DABOLIM,PUNE,72,69,141
335,DABOLIM,RAIPUR,12,13,25
336,DABOLIM,RAJKOT,11,9,20
337,DABOLIM,SURAT,38,37,75
338,GORAKHPUR,HYDERABAD,35,30,65
339,GORAKHPUR,KANPUR,2,1,3
340,GORAKHPUR,KOLKATA,20,17,37
341,GORAKHPUR,LUCKNOW,5,4,9
342,GORAKHPUR,MUMBAI,59,56,115
343,GORAKHPUR,VARANASI,2,1,3
344,GWALIOR,HYDERABAD,4,5,9
345,GWALIOR,INDORE,13,14,27
346,GWALIOR,JAMMU,3,2,5
347,GWALIOR,KOLKATA,13,13,26
348,GWALIOR,MUMBAI,4,4,8
349,HUBLI,HYDERABAD,18,15,33
350,HUBLI,MANGALORE,2,3,5
351,HUBLI,MUMBAI,18,20,38
352,HUBLI,MYSORE,4,2,6
353,HYDERABAD,IMPHAL,3,4,7
354,HYDERABAD,INDORE,87,101,188
355,HYDERABAD,JABALPUR,18,20,38
356,HYDERABAD,JAGDALPUR,9,9,18
357,HYDERABAD,JAIPUR,134,124,258
358,HYDERABAD,JAMMU,5,21,26
359,HYDERABAD,JAMNAGAR,5,4,9
360,HYDERABAD,JHARSUGUDA,5,5,10
361,HYDERABAD,JODHPUR,16,15,31
362,HYDERABAD,KADAPA,13,12,25
363,HYDERABAD,KANNUR,17,16,33
364,HYDERABAD,KOCHI,158,143,301
365,HYDERABAD,KOLHAPUR,24,22,46
366,HYDERABAD,KOLKATA,313,312,625
367,HYDERABAD,KOZHIKODE,19,19,38
368,HYDERABAD,LUCKNOW,67,84,151
369,HYDERABAD,MADURAI,40,39,79
370,HYDERABAD,MANGALORE,37,35,72
371,HYDERABAD,MUMBAI,575,592,1167
372,HYDERABAD,MYSORE,26,24,50
373,HYDERABAD,NAGPUR,18,19,37
374,HYDERABAD,NASIK,6,6,12
375,HYDERABAD,PATNA,80,78,158
376,HYDERABAD,PONDICHERRY,22,23,45
377,HYDERABAD,PUNE,158,157,315
378,HYDERABAD,RAIPUR,65,74,139
379,HYDERABAD,RAJAHMUNDRY,87,87,174
380,HYDERABAD,RANCHI,44,47,91
381,HYDERABAD,SHIRDI,71,74,145
382,HYDERABAD,SRINAGAR,35,38,73
383,HYDERABAD,SURAT,34,45,79
384,HYDERABAD,TIRUCHIRAPALLY,34,30,64
385,HYDERABAD,TIRUPATI,224,221,445
386,HYDERABAD,TRIVANDRUM,48,47,95
387,HYDERABAD,UDAIPUR,23,26,49
388,HYDERABAD,VADODARA,46,48,94
389,HYDERABAD,VARANASI,91,97,188
390,HYDERABAD,VIJAYAWADA,94,96,190
391,HYDERABAD,VISAKHAPATNAM,257,242,499
392,INDORE,JABALPUR,8,9,17
393,INDORE,JAIPUR,20,19,39
394,INDORE,JAMMU,14,14,28
395,INDORE,KOLKATA,37,32,69
396,INDORE,LUCKNOW,15,21,36
397,INDORE,MUMBAI,212,207,419
398,INDORE,NAGPUR,16,17,33
399,INDORE,PUNE,38,37,75
400,INDORE,RAIPUR,33,27,60
401,IMPHAL,KOLKATA,120,109,229
402,IMPHAL,MUMBAI,6,4,10
403,IMPHAL,SHILLONG,7,7,14
404,NASIK,PUNE,6,5,11
405,AGARTALA,AHMEDABAD,3,4,7
406,AGARTALA,AIZAWL,5,4,9
407,AGARTALA,BENGALURU,42,41,83
408,AGARTALA,CHENNAI,20,17,37
409,AGARTALA,DELHI,49,44,93
410,AGARTALA,DIBRUGARH,11,14,25
411,AGARTALA,GUWAHATI,61,60,121
412,AGARTALA,IMPHAL,11,19,30
413,AGARTALA,KOLKATA,360,321,681
414,AGARTALA,SHILLONG,8,7,15
415,BAGDOGRA,BENGALURU,136,120,256
416,BAGDOGRA,CHENNAI,73,69,142
417,BAGDOGRA,DELHI,359,338,697
418,BAGDOGRA,DIBRUGARH,38,27,65
419,BAGDOGRA,HYDERABAD,50,50,100
420,BAGDOGRA,KOLKATA,206,177,383
421,BAGDOGRA,MUMBAI,63,60,123
422,CHANDIGARH,CHENNAI,36,42,78
423,CHANDIGARH,DABOLIM,57,63,120
424,CHANDIGARH,DEHRA DUN,22,11,33
425,CHANDIGARH,DELHI,257,263,520
426,CHANDIGARH,DHARAMSALA,6,6,12
427,CHANDIGARH,GUWAHATI,13,14,27
428,CHANDIGARH,HYDERABAD,77,78,155
429,CHANDIGARH,JAIPUR,33,25,58
430,CHANDIGARH,KOLKATA,19,29,48
431,CHANDIGARH,KULLU,3,1,4
432,CHANDIGARH,LEH,7,12,19
433,CHANDIGARH,LUCKNOW,26,29,55
434,CHANDIGARH,MUMBAI,252,242,494
435,CHANDIGARH,PATNA,24,27,51
436,CHANDIGARH,PUNE,45,41,86
437,CHANDIGARH,SRINAGAR,104,108,212
438,CHANDIGARH,VADODARA,22,1,23
439,ALLAHABAD,BENGALURU,17,16,33
440,ALLAHABAD,BHOPAL,6,6,12
441,ALLAHABAD,BHUBANESWAR,12,14,26
442,ALLAHABAD,BILASPUR,4,5,9
443,ALLAHABAD,DEHRA DUN,10,11,21
444,ALLAHABAD,DELHI,50,46,96
445,ALLAHABAD,GORAKHPUR,9,9,18
446,ALLAHABAD,INDORE,19,14,33
447,ALLAHABAD,LUCKNOW,9,8,17
448,ALLAHABAD,MUMBAI,28,27,55
449,ALLAHABAD,PUNE,19,18,37
450,ALLAHABAD,RAIPUR,18,17,35
451,MANGALORE,MUMBAI,146,185,331
452,MANGALORE,PUNE,9,10,19
453,BELGAUM,BENGALURU,21,20,41
454,BELGAUM,DELHI,24,21,45
455,BELGAUM,HYDERABAD,29,28,57
456,BELGAUM,INDORE,4,4,8
457,BELGAUM,JODHPUR,5,4,9
458,BELGAUM,MUMBAI,23,24,47
459,BELGAUM,NAGPUR,3,3,6
460,BELGAUM,NASIK,2,2,4
461,BELGAUM,PUNE,7,6,13
462,BELGAUM,SURAT,4,4,8
463,BELGAUM,TIRUPATI,3,3,6
464,JAMMU,LEH,18,30,48
465,JAMMU,MUMBAI,21,64,85
466,JAMMU,SRINAGAR,170,164,334
467,LEH,MUMBAI,22,41,63
468,LEH,SRINAGAR,89,10,99
469,MADURAI,MUMBAI,54,57,111
470,MADURAI,TIRUPATI,11,8,19
471,MADURAI,VIJAYAWADA,2,2,4
472,PASIGHAT,TEZPUR,1,1,2
473,AURANGABAD,DELHI,60,62,122
474,AURANGABAD,HYDERABAD,26,22,48
475,AURANGABAD,MUMBAI,67,66,133
476,KANDLA,MUMBAI,18,19,37
477,PORT BLAIR,VISAKHAPATNAM,12,19,31
478,JAIPUR,KOLKATA,118,138,256
479,JAIPUR,LEH,22,1,23
480,JAIPUR,LUCKNOW,17,17,34
481,JAIPUR,MUMBAI,286,290,576
482,JAIPUR,PATNA,2,2,4
483,JAIPUR,PUNE,86,73,159
484,JAIPUR,SURAT,18,18,36
485,JAIPUR,UDAIPUR,9,8,17
486,JAIPUR,VADODARA,4,3,7
487,JAIPUR,VARANASI,8,8,16
488,JODHPUR,KOLKATA,10,8,18
489,JODHPUR,MUMBAI,69,74,143
490,JAMNAGAR,MUMBAI,24,29,53
491,JAGDALPUR,RAIPUR,10,10,20
492,JABALPUR,KOLKATA,2,2,4
493,JABALPUR,MUMBAI,32,30,62
494,JABALPUR,PUNE,15,14,29
495,JHARSUGUDA,KOLKATA,12,13,25
496,JHARSUGUDA,RAIPUR,8,6,14
497,JORHAT,KOLKATA,33,34,67
498,KURNOOL,VISAKHAPATNAM,5,6,11
499,KOLHAPUR,TIRUPATI,14,18,32
500,KANPUR,MUMBAI,48,48,96
501,AJMER,DELHI,13,13,26
502,AJMER,HYDERABAD,8,10,18
503,AJMER,INDORE,3,4,7
504,AJMER,MUMBAI,3,4,7
505,AJMER,SURAT,4,4,8
506,LUCKNOW,MUMBAI,216,226,442
507,LUCKNOW,NAGPUR,16,12,28
508,LUCKNOW,PANTNAGAR,5,4,9
509,LUCKNOW,PATNA,33,34,67
510,LUCKNOW,PUNE,37,29,66
511,LUCKNOW,RAIPUR,7,7,14
512,LUCKNOW,RANCHI,28,31,59
513,LUCKNOW,SRINAGAR,11,16,27
514,LUCKNOW,VARANASI,4,2,6
515,CHENNAI,COIMBATORE,283,277,560
516,CHENNAI,DABOLIM,43,45,88
517,CHENNAI,DARBHANGA,5,3,8
518,CHENNAI,DEHRA DUN,7,8,15
519,CHENNAI,DELHI,736,754,1490
520,CHENNAI,DIBRUGARH,8,9,17
521,CHENNAI,DURGAPUR,38,40,78
522,CHENNAI,GORAKHPUR,1,21,22
523,CHENNAI,GUWAHATI,127,132,259
524,CHENNAI,HUBLI,16,15,31
525,CHENNAI,HYDERABAD,396,387,783
526,CHENNAI,INDORE,13,13,26
527,CHENNAI,JABALPUR,3,4,7
528,CHENNAI,JAIPUR,44,39,83
529,CHENNAI,JODHPUR,45,47,92
530,CHENNAI,KADAPA,4,4,8
531,CHENNAI,KANNUR,20,18,38
532,CHENNAI,KOCHI,163,159,322
533,CHENNAI,KOLKATA,343,323,666
534,CHENNAI,KOZHIKODE,18,19,37
535,CHENNAI,KURNOOL,4,4,8
536,CHENNAI,LUCKNOW,39,41,80
537,CHENNAI,MADURAI,126,124,250
538,CHENNAI,MANGALORE,19,18,37
539,CHENNAI,MUMBAI,582,607,1189
540,CHENNAI,MYSORE,21,19,40
541,CHENNAI,NAGPUR,2,1,3
542,CHENNAI,PATNA,15,14,29
543,CHENNAI,PORT BLAIR,143,130,273
544,CHENNAI,PUNE,193,200,393
545,CHENNAI,RAIPUR,24,26,50
546,CHENNAI,RAJAHMUNDRY,17,19,36
547,CHENNAI,RANCHI,28,38,66
548,CHENNAI,SHIRDI,57,57,114
549,CHENNAI,SRINAGAR,7,6,13
550,CHENNAI,SURAT,20,21,41
551,CHENNAI,TIRUCHIRAPALLY,70,64,134
552,CHENNAI,TRIVANDRUM,130,133,263
553,CHENNAI,TUTICORIN,63,62,125
554,CHENNAI,VADODARA,6,6,12
555,CHENNAI,VARANASI,27,25,52
556,CHENNAI,VIJAYAWADA,40,46,86
557,CHENNAI,VISAKHAPATNAM,84,90,174
558,NAGPUR,PUNE,125,106,231
559,BILASPUR,DELHI,5,4,9
560,BILASPUR,JABALPUR,4,3,7
561,PATNA,PUNE,44,38,82
562,PATNA,RANCHI,39,34,73
563,PATNA,VARANASI,2,1,3
564,PUNE,RAIPUR,19,19,38
565,PUNE,RANCHI,43,46,89
566,PUNE,TIRUPATI,10,9,19
567,DURGAPUR,GUWAHATI,2,2,4
568,DURGAPUR,HYDERABAD,23,21,44
569,DURGAPUR,MUMBAI,33,31,64
570,DURGAPUR,SRINAGAR,22,1,23
571,DURGAPUR,TRIVANDRUM,1,1,2
572,DURGAPUR,VADODARA,22,1,23
573,RAJAHMUNDRY,TIRUPATI,7,5,12
574,RAJAHMUNDRY,VISAKHAPATNAM,5,5,10
575,RAIPUR,SRINAGAR,10,9,19
576,RAIPUR,VISAKHAPATNAM,4,21,25
577,SHIRDI,TIRUPATI,9,9,18
578,SHIRDI,VISAKHAPATNAM,1,21,22
579,SHILLONG,SILCHAR,6,7,13
580,TIRUPATI,VIJAYAWADA,10,10,20
581,TIRUPATI,VISAKHAPATNAM,18,20,38
582,GHAZIABAD,HUBLI,8,7,15
583,GHAZIABAD,"KALABURAGI, KARNATAKA",4,4,8
584,VIJAYAWADA,VISAKHAPATNAM,16,17,33
585,Deoghar Airport,KOLKATA,8,7,15
586,Deoghar Airport,DELHI,4,4,8
