S.No.,CITY 1,CITY 2,AVG FLIGHTS TO CITY 2,AVG FLIGHTS FROM CITY 2,TOTAL AVG FLIGHTS
1,AGARTALA,AHMEDABAD,3,4,7
2,AGARTALA,AIZAWL,5,5,10
3,AGARTALA,BENGALURU,42,38,80
5,AGARTALA,CHENNAI,19,19,38
6,AGARTALA,DELHI,51,51,102
7,AGARTALA,DIBRUGARH,9,13,22
8,AGARTALA,GUWAHATI,58,59,117
9,AGARTALA,IMPHAL,12,18,30
10,AGARTALA,KOLKATA,316,323,639
11,AGARTALA,SHILLONG,7,6,13
12,AGATTI ISLAND,BENGALURU,1,1,2
13,AGATTI ISLAND,KOCHI,12,15,27
14,AGATTI ISLAND,MYSORE,1,1,2
15,AGRA,AHMEDABAD,9,9,18
16,AGRA,BENGALURU,24,23,47
17,AGRA,BHOPAL,4,4,8
18,AGRA,LUCKNOW,5,7,12
19,AGRA,MUMBAI,19,17,36
20,AHMEDABAD,AMRITSAR,15,18,33
21,AHMEDABAD,BAGDOGRA,45,53,98
22,AHMEDABAD,BELGAUM,8,9,17
23,AHMEDABAD,BENGALURU,252,257,509
24,AHMEDABAD,BHOPAL,12,15,27
25,AHMEDABAD,BHUBANESWAR,32,32,64
26,AHMEDABAD,BHUJ,6,6,12
27,AHMEDABAD,CHANDIGARH,76,75,151
28,AHMEDABAD,CHENNAI,113,115,228
29,AHMEDABAD,COIMBATORE,13,9,22
30,AHMEDABAD,DABOLIM,156,183,339
31,AHMEDABAD,DEHRA DUN,60,71,131
32,AHMEDABAD,DELHI,570,706,1276
33,AHMEDABAD,DURGAPUR,2,3,5
34,AHMEDABAD,GUWAHATI,8,8,16
35,AHMEDABAD,GWALIOR,8,10,18
36,AHMEDABAD,HYDERABAD,129,128,257
37,AHMEDABAD,INDORE,15,15,30
38,AHMEDABAD,JAIPUR,49,52,101
39,AHMEDABAD,JODHPUR,14,14,28
40,AHMEDABAD,KOCHI,36,33,69
41,AHMEDABAD,KOLHAPUR,7,6,13
42,AHMEDABAD,KOLKATA,136,154,290
43,AHMEDABAD,LUCKNOW,77,88,165
44,AHMEDABAD,MUMBAI,439,434,873
45,AHMEDABAD,NAGPUR,26,28,54
46,AHMEDABAD,NASIK,10,9,19
47,AHMEDABAD,PATNA,51,67,118
48,AHMEDABAD,PUNE,141,136,277
49,AHMEDABAD,RAIPUR,26,26,52
50,AHMEDABAD,RANCHI,21,22,43
51,AHMEDABAD,SHIRDI,5,4,9
52,AHMEDABAD,TRIVANDRUM,2,1,3
53,AHMEDABAD,VARANASI,32,49,81
54,AHMEDABAD,VISAKHAPATNAM,7,5,12
55,AIZAWL,DELHI,17,17,34
56,AIZAWL,GUWAHATI,41,37,78
57,AIZAWL,IMPHAL,6,7,13
58,AIZAWL,KOLKATA,57,52,109
59,AIZAWL,MUMBAI,1,1,2
60,AIZAWL,SHILLONG,5,4,9
62,AJMER,DELHI,17,19,36
63,AJMER,HYDERABAD,19,20,39
64,AJMER,INDORE,3,3,6
65,AJMER,MUMBAI,8,8,16
66,AJMER,SURAT,5,5,10
67,ALLAHABAD,BENGALURU,37,31,68
68,ALLAHABAD,BHOPAL,10,8,18
69,ALLAHABAD,BHUBANESWAR,11,11,22
70,ALLAHABAD,BILASPUR,4,4,8
71,ALLAHABAD,DEHRA DUN,18,19,37
72,ALLAHABAD,DELHI,51,47,98
73,ALLAHABAD,GORAKHPUR,13,12,25
74,ALLAHABAD,INDORE,17,12,29
75,ALLAHABAD,JABALPUR,1,1,2
76,ALLAHABAD,LUCKNOW,9,9,18
77,ALLAHABAD,MUMBAI,35,33,68
78,ALLAHABAD,PUNE,21,19,40
79,ALLAHABAD,RAIPUR,20,17,37
80,AMRITSAR,BENGALURU,23,17,40
81,AMRITSAR,CHANDIGARH,1,4,5
82,AMRITSAR,CHENNAI,1,3,4
83,AMRITSAR,DABOLIM,16,17,33
84,AMRITSAR,DELHI,247,221,468
85,AMRITSAR,GUWAHATI,3,4,7
86,AMRITSAR,HYDERABAD,3,2,5
87,AMRITSAR,JAIPUR,11,9,20
89,AMRITSAR,KOLKATA,45,42,87
90,AMRITSAR,LUCKNOW,26,22,48
91,AMRITSAR,MUMBAI,134,100,234
92,AMRITSAR,PATNA,16,16,32
93,AMRITSAR,PUNE,37,34,71
94,AMRITSAR,SRINAGAR,106,102,208
95,AURANGABAD,DELHI,56,74,130
96,AURANGABAD,HYDERABAD,25,23,48
97,AURANGABAD,MUMBAI,60,60,120
98,BAGDOGRA,BENGALURU,138,126,264
99,BAGDOGRA,CHENNAI,84,69,153
100,BAGDOGRA,DELHI,391,421,812
101,BAGDOGRA,DIBRUGARH,14,11,25
103,BAGDOGRA,HYDERABAD,47,47,94
104,BAGDOGRA,KOLKATA,285,238,523
105,BAGDOGRA,MUMBAI,128,102,230
106,BAGDOGRA,RANCHI,1,1,2
107,BAREILLY,BENGALURU,28,25,53
108,BAREILLY,DELHI,15,13,28
109,BAREILLY,MUMBAI,28,22,50
110,BELGAUM,BENGALURU,21,19,40
111,BELGAUM,DELHI,44,42,86
112,BELGAUM,HYDERABAD,32,31,63
113,BELGAUM,INDORE,4,3,7
114,BELGAUM,JODHPUR,5,5,10
115,BELGAUM,MUMBAI,27,27,54
116,BELGAUM,NAGPUR,3,3,6
117,BELGAUM,NASIK,5,5,10
118,BELGAUM,PUNE,9,8,17
119,BELGAUM,SURAT,5,4,9
120,BELGAUM,TIRUPATI,4,3,7
121,BENGALURU,BHOPAL,37,41,78
122,BENGALURU,BHUBANESWAR,190,197,387
123,BENGALURU,"BIDAR AIRPORT, KARNATAKA",4,4,8
124,BENGALURU,CHANDIGARH,151,158,309
125,BENGALURU,CHENNAI,293,299,592
126,BENGALURU,COIMBATORE,117,123,240
127,BENGALURU,DABOLIM,328,335,663
128,BENGALURU,DARBHANGA,79,99,178
129,BENGALURU,DEHRA DUN,79,88,167
130,BENGALURU,DELHI,1479,1600,3079
131,BENGALURU,DIMAPUR,9,9,18
132,BENGALURU,DURGAPUR,40,47,87
133,BENGALURU,GORAKHPUR,12,11,23
134,BENGALURU,GUWAHATI,152,184,336
135,BENGALURU,GWALIOR,20,20,40
136,BENGALURU,HUBLI,44,44,88
137,BENGALURU,HYDERABAD,571,543,1114
138,BENGALURU,IMPHAL,10,8,18
139,BENGALURU,INDORE,117,128,245
140,BENGALURU,JABALPUR,17,18,35
141,BENGALURU,JAIPUR,177,185,362
142,BENGALURU,JAMMU,9,10,19
143,BENGALURU,JAMNAGAR,5,5,10
144,BENGALURU,JHARSUGUDA,29,30,59
145,BENGALURU,JODHPUR,27,29,56
146,BENGALURU,JORHAT,6,6,12
147,BENGALURU,KADAPA,3,4,7
148,BENGALURU,"KALABURAGI, KARNATAKA",27,27,54
149,BENGALURU,KANNUR,42,47,89
150,BENGALURU,KANPUR,25,30,55
151,BENGALURU,KOCHI,300,330,630
152,BENGALURU,KOLHAPUR,7,6,13
153,BENGALURU,KOLKATA,656,625,1281
154,BENGALURU,KOZHIKODE,36,36,72
155,BENGALURU,KURNOOL,7,8,15
156,BENGALURU,LUCKNOW,156,184,340
157,BENGALURU,MADURAI,49,54,103
158,BENGALURU,MANGALORE,151,160,311
159,BENGALURU,MUMBAI,1045,1040,2085
160,BENGALURU,MYSORE,4,7,11
161,BENGALURU,NAGPUR,108,114,222
162,BENGALURU,PATNA,181,223,404
163,BENGALURU,PONDICHERRY,15,17,32
164,BENGALURU,PORT BLAIR,83,79,162
165,BENGALURU,PUNE,394,380,774
166,BENGALURU,RAIPUR,89,87,176
167,BENGALURU,RAJAHMUNDRY,33,35,68
168,BENGALURU,RAJKOT,43,45,88
169,BENGALURU,RANCHI,135,140,275
170,BENGALURU,SHIRDI,61,59,120
171,BENGALURU,SRINAGAR,20,14,34
172,BENGALURU,SURAT,52,51,103
173,BENGALURU,TIRUCHIRAPALLY,37,34,71
174,BENGALURU,TIRUPATI,20,20,40
175,BENGALURU,TRIVANDRUM,139,149,288
176,BENGALURU,TUTICORIN,17,18,35
177,BENGALURU,UDAIPUR,17,16,33
178,BENGALURU,VADODARA,52,47,99
179,BENGALURU,VARANASI,94,157,251
180,BENGALURU,VIJAYAWADA,65,66,131
181,BENGALURU,VISAKHAPATNAM,143,157,300
182,BHAVNAGAR,MUMBAI,18,20,38
183,BHAVNAGAR,PUNE,11,10,21
184,BHOPAL,CHENNAI,13,14,27
185,BHOPAL,DELHI,166,180,346
186,BHOPAL,HYDERABAD,26,24,50
187,BHOPAL,KOCHI,7,7,14
188,BHOPAL,MUMBAI,117,103,220
189,BHOPAL,PUNE,20,17,37
190,BHOPAL,RAIPUR,16,15,31
191,BHUBANESWAR,CHANDIGARH,10,10,20
192,BHUBANESWAR,CHENNAI,81,80,161
194,BHUBANESWAR,DELHI,345,390,735
195,BHUBANESWAR,HYDERABAD,136,120,256
196,BHUBANESWAR,JAIPUR,18,19,37
197,BHUBANESWAR,JHARSUGUDA,12,12,24
198,BHUBANESWAR,KOLKATA,142,158,300
199,BHUBANESWAR,MUMBAI,186,175,361
200,BHUBANESWAR,PATNA,24,26,50
201,BHUBANESWAR,PUNE,38,31,69
202,BHUBANESWAR,RAIPUR,20,17,37
203,BHUBANESWAR,RANCHI,4,4,8
204,BHUBANESWAR,VARANASI,7,9,16
205,BHUJ,MUMBAI,10,11,21
206,BIKANER,DELHI,12,13,25
207,BILASPUR,DELHI,4,5,9
208,BILASPUR,JABALPUR,3,4,7
209,CHANDIGARH,CHENNAI,44,42,86
210,CHANDIGARH,DABOLIM,66,66,132
211,CHANDIGARH,DEHRA DUN,1,3,4
212,CHANDIGARH,DELHI,294,276,570
213,CHANDIGARH,DHARAMSALA,10,10,20
214,CHANDIGARH,GUWAHATI,9,8,17
215,CHANDIGARH,HYDERABAD,123,110,233
216,CHANDIGARH,JAIPUR,34,25,59
218,CHANDIGARH,KOLKATA,27,28,55
219,CHANDIGARH,KULLU,5,1,6
220,CHANDIGARH,LEH,8,10,18
221,CHANDIGARH,LUCKNOW,36,40,76
222,CHANDIGARH,MUMBAI,376,338,714
223,CHANDIGARH,PATNA,25,29,54
224,CHANDIGARH,PUNE,59,50,109
225,CHANDIGARH,SRINAGAR,117,118,235
227,CHENNAI,COIMBATORE,285,287,572
228,CHENNAI,DABOLIM,43,45,88
229,CHENNAI,DARBHANGA,6,6,12
230,CHENNAI,DEHRA DUN,8,9,17
231,CHENNAI,DELHI,686,760,1446
232,CHENNAI,DIBRUGARH,7,8,15
233,CHENNAI,DURGAPUR,52,51,103
235,CHENNAI,GUWAHATI,115,121,236
236,CHENNAI,HUBLI,15,17,32
237,CHENNAI,HYDERABAD,403,373,776
238,CHENNAI,INDORE,14,12,26
239,CHENNAI,JABALPUR,5,8,13
240,CHENNAI,JAIPUR,42,40,82
241,CHENNAI,JODHPUR,46,46,92
242,CHENNAI,KADAPA,2,3,5
243,CHENNAI,KANNUR,19,18,37
244,CHENNAI,KOCHI,173,177,350
245,CHENNAI,KOLKATA,374,355,729
246,CHENNAI,KOZHIKODE,16,18,34
247,CHENNAI,KURNOOL,6,7,13
248,CHENNAI,LUCKNOW,37,39,76
249,CHENNAI,MADURAI,124,126,250
250,CHENNAI,MANGALORE,19,19,38
251,CHENNAI,MUMBAI,606,621,1227
252,CHENNAI,MYSORE,19,18,37
253,CHENNAI,NAGPUR,16,12,28
254,CHENNAI,NASIK,3,4,7
255,CHENNAI,PATNA,22,26,48
256,CHENNAI,PORT BLAIR,189,183,372
257,CHENNAI,PUNE,217,207,424
258,CHENNAI,RAIPUR,27,29,56
259,CHENNAI,RAJAHMUNDRY,23,24,47
261,CHENNAI,RANCHI,30,36,66
262,CHENNAI,SHIRDI,52,49,101
263,CHENNAI,SRINAGAR,9,9,18
264,CHENNAI,SURAT,31,31,62
265,CHENNAI,TIRUCHIRAPALLY,72,65,137
266,CHENNAI,TRIVANDRUM,130,136,266
267,CHENNAI,TUTICORIN,65,63,128
268,CHENNAI,VADODARA,6,7,13
269,CHENNAI,VARANASI,24,24,48
270,CHENNAI,VIJAYAWADA,44,48,92
271,CHENNAI,VISAKHAPATNAM,102,108,210
272,COIMBATORE,DELHI,142,151,293
273,COIMBATORE,GUWAHATI,5,3,8
274,COIMBATORE,HYDERABAD,174,157,331
275,COIMBATORE,JAIPUR,5,5,10
276,COIMBATORE,MANGALORE,3,2,5
277,COIMBATORE,MUMBAI,161,152,313
278,COIMBATORE,PUNE,42,32,74
279,COIMBATORE,SURAT,7,6,13
280,COIMBATORE,TIRUPATI,5,6,11
282,DABOLIM,DELHI,716,752,1468
284,DABOLIM,HYDERABAD,347,320,667
285,DABOLIM,INDORE,36,34,70
286,DABOLIM,JAIPUR,38,38,76
287,DABOLIM,KOLKATA,46,46,92
288,DABOLIM,LUCKNOW,40,41,81
289,DABOLIM,MUMBAI,727,642,1369
290,DABOLIM,MYSORE,10,11,21
291,DABOLIM,NAGPUR,29,27,56
292,DABOLIM,PUNE,82,72,154
293,DABOLIM,RAIPUR,10,9,19
294,DABOLIM,RAJKOT,19,16,35
295,DABOLIM,SURAT,48,40,88
296,DARBHANGA,DELHI,91,88,179
297,DARBHANGA,HYDERABAD,47,39,86
298,DARBHANGA,KOLKATA,40,27,67
299,DARBHANGA,MUMBAI,93,70,163
300,DEHRA DUN,DELHI,295,259,554
301,DEHRA DUN,GUWAHATI,10,7,17
302,DEHRA DUN,HYDERABAD,45,42,87
303,DEHRA DUN,JAIPUR,40,28,68
304,DEHRA DUN,KOLKATA,23,16,39
305,DEHRA DUN,LUCKNOW,41,38,79
306,DEHRA DUN,MUMBAI,120,113,233
307,DEHRA DUN,PANTNAGAR,11,12,23
308,DEHRA DUN,PUNE,9,10,19
309,DEHRA DUN,VARANASI,13,13,26
310,DELHI,DHARAMSALA,81,65,146
311,DELHI,DIBRUGARH,107,76,183
312,DELHI,DIMAPUR,23,24,47
313,DELHI,DURGAPUR,45,41,86
314,DELHI,GAYA,37,39,76
315,DELHI,GORAKHPUR,109,122,231
316,DELHI,GUWAHATI,487,484,971
317,DELHI,GWALIOR,16,19,35
318,DELHI,HYDERABAD,996,846,1842
319,DELHI,IMPHAL,89,84,173
320,DELHI,INDORE,283,243,526
321,DELHI,JABALPUR,92,78,170
322,DELHI,JAGDALPUR,3,5,8
323,DELHI,JAIPUR,190,160,350
324,DELHI,JAMMU,310,355,665
325,DELHI,JHARSUGUDA,48,43,91
326,DELHI,JODHPUR,44,43,87
327,DELHI,JORHAT,8,10,18
328,DELHI,KANDLA,22,17,39
329,DELHI,KANNUR,20,15,35
330,DELHI,KANPUR,23,24,47
331,DELHI,KHAJURAHO,4,5,9
332,DELHI,KOCHI,351,334,685
333,DELHI,KOLKATA,1094,899,1993
334,DELHI,KOZHIKODE,65,63,128
335,DELHI,KULLU,7,4,11
336,DELHI,LEH,518,466,984
337,DELHI,LUCKNOW,392,445,837
338,DELHI,MADURAI,49,50,99
339,DELHI,MANGALORE,7,9,16
340,DELHI,MUMBAI,2004,1679,3683
341,DELHI,NAGPUR,238,200,438
342,DELHI,NASIK,4,5,9
343,DELHI,PAKYONG,2,1,3
344,DELHI,PANTNAGAR,30,32,62
345,DELHI,PATHANKOT,5,6,11
346,DELHI,PATNA,621,656,1277
347,DELHI,PORBANDAR,8,6,14
348,DELHI,PORT BLAIR,57,52,109
349,DELHI,PUNE,897,749,1646
350,DELHI,RAIPUR,306,273,579
351,DELHI,RAJKOT,119,103,222
352,DELHI,RANCHI,364,327,691
353,DELHI,SHILLONG,1,1,2
354,DELHI,SHIRDI,93,84,177
355,DELHI,SILCHAR,18,17,35
356,DELHI,SRINAGAR,1340,1301,2641
357,DELHI,SURAT,232,177,409
358,DELHI,TIRUCHIRAPALLY,9,8,17
359,DELHI,TIRUPATI,27,23,50
360,DELHI,TRIVANDRUM,118,114,232
361,DELHI,UDAIPUR,130,122,252
362,DELHI,VADODARA,183,153,336
363,DELHI,VARANASI,264,269,533
364,DELHI,VIJAYAWADA,85,84,169
365,DELHI,VISAKHAPATNAM,207,177,384
366,DELHI,Kushinagar International Airport,17,19,36
367,DHARAMSALA,JAIPUR,10,13,23
368,DIBRUGARH,DIMAPUR,3,1,4
369,DIBRUGARH,GUWAHATI,34,22,56
370,DIBRUGARH,IMPHAL,6,7,13
371,DIBRUGARH,KOLKATA,86,71,157
372,DIBRUGARH,MUMBAI,7,9,16
373,DIBRUGARH,SHILLONG,2,3,5
374,DIMAPUR,GUWAHATI,8,7,15
375,DIMAPUR,IMPHAL,11,13,24
376,DIMAPUR,KOLKATA,52,38,90
377,DIMAPUR,MUMBAI,2,2,4
378,DIMAPUR,SHILLONG,1,1,2
379,DIU,MUMBAI,16,16,32
380,DURGAPUR,GUWAHATI,2,3,5
381,DURGAPUR,HYDERABAD,30,22,52
383,DURGAPUR,MUMBAI,47,37,84
386,GAYA,KOLKATA,12,10,22
387,GHAZIABAD,HUBLI,8,8,16
388,GHAZIABAD,"KALABURAGI, KARNATAKA",4,4,8
389,GORAKHPUR,HYDERABAD,39,31,70
390,GORAKHPUR,KANPUR,5,4,9
391,GORAKHPUR,KOLKATA,20,18,38
393,GORAKHPUR,MUMBAI,99,86,185
394,GORAKHPUR,VARANASI,13,6,19
395,GUWAHATI,HYDERABAD,43,41,84
396,GUWAHATI,IMPHAL,129,131,260
397,GUWAHATI,JAIPUR,61,54,115
398,GUWAHATI,JODHPUR,1,2,3
399,GUWAHATI,JORHAT,9,10,19
400,GUWAHATI,KOLKATA,315,304,619
401,GUWAHATI,LUCKNOW,36,34,70
402,GUWAHATI,MUMBAI,118,95,213
403,GUWAHATI,PASIGHAT,3,2,5
404,GUWAHATI,PATNA,45,51,96
405,GUWAHATI,PUNE,38,37,75
406,GUWAHATI,RUPSI,5,4,9
407,GUWAHATI,SHILLONG,1,1,2
408,GUWAHATI,SILCHAR,41,50,91
409,GUWAHATI,TEZPUR,2,1,3
410,GUWAHATI,TEZU,2,2,4
411,GUWAHATI,VARANASI,9,10,19
412,GWALIOR,HYDERABAD,18,15,33
413,GWALIOR,INDORE,16,13,29
414,GWALIOR,JAMMU,10,9,19
415,GWALIOR,KOLKATA,16,14,30
416,GWALIOR,MUMBAI,11,9,20
417,HUBLI,HYDERABAD,19,14,33
418,HUBLI,MANGALORE,5,5,10
419,HUBLI,MUMBAI,16,17,33
420,HUBLI,MYSORE,4,4,8
421,HYDERABAD,IMPHAL,4,5,9
422,HYDERABAD,INDORE,81,92,173
423,HYDERABAD,JABALPUR,16,19,35
424,HYDERABAD,JAGDALPUR,11,11,22
425,HYDERABAD,JAIPUR,116,129,245
427,HYDERABAD,JAMNAGAR,6,6,12
428,HYDERABAD,JHARSUGUDA,16,16,32
429,HYDERABAD,JODHPUR,17,17,34
430,HYDERABAD,KADAPA,13,13,26
431,HYDERABAD,KANNUR,14,16,30
432,HYDERABAD,KOCHI,162,160,322
433,HYDERABAD,KOLHAPUR,30,28,58
434,HYDERABAD,KOLKATA,322,318,640
435,HYDERABAD,KOZHIKODE,17,18,35
436,HYDERABAD,LUCKNOW,75,103,178
437,HYDERABAD,MADURAI,38,41,79
438,HYDERABAD,MANGALORE,34,37,71
439,HYDERABAD,MUMBAI,580,628,1208
440,HYDERABAD,MYSORE,26,25,51
441,HYDERABAD,NAGPUR,16,17,33
442,HYDERABAD,PATNA,87,110,197
443,HYDERABAD,PONDICHERRY,23,21,44
444,HYDERABAD,PUNE,131,134,265
445,HYDERABAD,RAIPUR,72,79,151
446,HYDERABAD,RAJAHMUNDRY,88,88,176
447,HYDERABAD,RANCHI,52,60,112
448,HYDERABAD,SHIRDI,71,71,142
449,HYDERABAD,SRINAGAR,37,37,74
450,HYDERABAD,SURAT,40,44,84
451,HYDERABAD,TIRUCHIRAPALLY,36,32,68
452,HYDERABAD,TIRUPATI,210,214,424
453,HYDERABAD,TRIVANDRUM,33,39,72
454,HYDERABAD,UDAIPUR,26,27,53
455,HYDERABAD,VADODARA,50,48,98
456,HYDERABAD,VARANASI,83,94,177
457,HYDERABAD,VIJAYAWADA,83,81,164
458,HYDERABAD,VISAKHAPATNAM,293,285,578
459,IMPHAL,KOLKATA,144,116,260
460,IMPHAL,MUMBAI,9,6,15
461,IMPHAL,SHILLONG,7,6,13
462,INDORE,JABALPUR,11,12,23
463,INDORE,JAIPUR,19,18,37
464,INDORE,JAMMU,16,15,31
465,INDORE,KOLKATA,31,35,66
466,INDORE,LUCKNOW,19,21,40
467,INDORE,MUMBAI,206,204,410
468,INDORE,NAGPUR,16,17,33
469,INDORE,PUNE,37,38,75
470,INDORE,RAIPUR,32,30,62
471,JABALPUR,MUMBAI,52,38,90
472,JABALPUR,PUNE,17,16,33
473,JAGDALPUR,RAIPUR,11,11,22
474,JAIPUR,KOLKATA,113,127,240
475,JAIPUR,LUCKNOW,17,19,36
476,JAIPUR,MUMBAI,303,282,585
477,JAIPUR,PATNA,4,7,11
478,JAIPUR,PUNE,107,79,186
479,JAIPUR,SURAT,20,16,36
480,JAIPUR,UDAIPUR,11,11,22
481,JAIPUR,VADODARA,3,2,5
482,JAIPUR,VARANASI,10,12,22
484,JAMMU,LEH,17,55,72
485,JAMMU,MUMBAI,15,69,84
486,JAMMU,SRINAGAR,172,132,304
487,JAMNAGAR,MUMBAI,27,30,57
488,JHARSUGUDA,KOLKATA,22,22,44
489,JHARSUGUDA,RAIPUR,8,5,13
490,JODHPUR,KOLKATA,10,10,20
491,JODHPUR,MUMBAI,49,50,99
492,JORHAT,KOLKATA,33,33,66
493,KADAPA,VIJAYAWADA,3,2,5
494,KADAPA,VISAKHAPATNAM,6,6,12
495,"KALABURAGI, KARNATAKA",TIRUPATI,4,3,7
496,KANDLA,MUMBAI,20,21,41
497,KANNUR,KOCHI,18,16,34
498,KANNUR,KOZHIKODE,1,1,2
499,KANNUR,MUMBAI,23,23,46
500,KANNUR,TRIVANDRUM,14,17,31
501,KANPUR,MUMBAI,74,56,130
502,KOCHI,KOLKATA,24,25,49
503,KOCHI,MUMBAI,276,259,535
504,KOCHI,MYSORE,9,9,18
505,KOCHI,PUNE,47,41,88
506,KOCHI,RANCHI,4,3,7
507,KOCHI,TRIVANDRUM,17,15,32
508,KOLHAPUR,TIRUPATI,14,17,31
509,KOLKATA,LILABARI,8,9,17
510,KOLKATA,LUCKNOW,76,85,161
511,KOLKATA,MANGALORE,4,5,9
512,KOLKATA,MUMBAI,556,534,1090
513,KOLKATA,NAGPUR,40,41,81
514,KOLKATA,PAKYONG,2,2,4
516,KOLKATA,PATNA,88,107,195
517,KOLKATA,PORT BLAIR,154,149,303
518,KOLKATA,PUNE,116,113,229
519,KOLKATA,RAIPUR,71,73,144
520,KOLKATA,RANCHI,53,53,106
521,KOLKATA,RUPSI,9,12,21
522,KOLKATA,SHILLONG,14,10,24
523,KOLKATA,SILCHAR,78,94,172
524,KOLKATA,SRINAGAR,18,14,32
525,KOLKATA,SURAT,69,55,124
527,KOLKATA,TRIVANDRUM,4,4,8
528,KOLKATA,UDAIPUR,5,3,8
529,KOLKATA,VARANASI,41,58,99
530,KOLKATA,VISAKHAPATNAM,47,43,90
531,KOZHIKODE,MUMBAI,59,65,124
532,KURNOOL,VISAKHAPATNAM,9,8,17
534,LEH,SRINAGAR,114,11,125
535,LUCKNOW,MUMBAI,306,233,539
536,LUCKNOW,NAGPUR,19,13,32
537,LUCKNOW,PANTNAGAR,8,7,15
538,LUCKNOW,PATNA,37,40,77
539,LUCKNOW,PUNE,38,29,67
540,LUCKNOW,RANCHI,34,31,65
541,LUCKNOW,SRINAGAR,1,2,3
542,LUCKNOW,VARANASI,3,10,13
543,MADURAI,MUMBAI,62,62,124
544,MADURAI,TIRUPATI,9,6,15
545,MADURAI,VIJAYAWADA,2,2,4
546,MANGALORE,MUMBAI,176,169,345
547,MANGALORE,PUNE,12,12,24
548,MUMBAI,NAGPUR,249,283,532
549,MUMBAI,PATNA,142,222,364
550,MUMBAI,PORBANDAR,16,12,28
551,MUMBAI,PUNE,1,1,2
552,MUMBAI,RAIPUR,128,148,276
553,MUMBAI,RAJKOT,121,104,225
554,MUMBAI,RANCHI,106,138,244
555,MUMBAI,SILCHAR,1,4,5
556,MUMBAI,SRINAGAR,174,280,454
557,MUMBAI,SURAT,13,13,26
558,MUMBAI,TIRUPATI,22,23,45
559,MUMBAI,TRIVANDRUM,100,93,193
560,MUMBAI,UDAIPUR,144,147,291
561,MUMBAI,VADODARA,143,146,289
562,MUMBAI,VARANASI,206,264,470
563,MUMBAI,VISAKHAPATNAM,63,67,130
564,MUMBAI,Sindhudurg Airport,17,16,33
565,NAGPUR,PUNE,137,114,251
566,NASIK,PUNE,10,9,19
567,PASIGHAT,TEZPUR,1,1,2
568,PATNA,PUNE,75,57,132
569,PATNA,RANCHI,36,37,73
570,PATNA,VARANASI,7,8,15
571,PORT BLAIR,VISAKHAPATNAM,18,28,46
572,PUNE,RAIPUR,21,21,42
573,PUNE,RANCHI,42,46,88
574,PUNE,SURAT,9,10,19
575,PUNE,TIRUPATI,10,10,20
576,RAIPUR,SRINAGAR,12,11,23
578,RAJAHMUNDRY,TIRUPATI,7,6,13
579,RAJAHMUNDRY,VISAKHAPATNAM,6,5,11
581,SHILLONG,SILCHAR,4,6,10
582,SHIRDI,TIRUPATI,9,9,18
584,TIRUPATI,VIJAYAWADA,8,10,18
585,TIRUPATI,VISAKHAPATNAM,18,19,37
586,VIJAYAWADA,VISAKHAPATNAM,17,17,34
587,Gondia Airport,HYDERABAD,9,8,17
588,Gondia Airport,INDORE,10,10,20
