S.No.,CITY 1,CITY 2,AVG FLIGHTS TO CITY 2,AVG FLIGHTS FROM CITY 2,TOTAL AVG FLIGHTS
1,AGARTALA,AHMEDABAD,2,2,4
2,AGARTALA,AIZAWL,4,4,8
3,AGARTALA,BENGALURU,27,28,55
5,AGARTALA,DELHI,64,60,124
6,AGARTALA,DIBRUGARH,7,7,14
7,AGARTALA,GUWAHATI,43,47,90
8,AGARTALA,IMPHAL,7,10,17
9,AGARTALA,KOLKATA,333,291,624
11,AGARTALA,SHILLONG,9,5,14
12,AGATTI ISLAND,BENGALURU,1,1,2
13,AGATTI ISLAND,KOCHI,14,18,32
14,AGATTI ISLAND,MYSORE,1,1,2
15,AGRA,BENGALURU,21,21,42
16,AGRA,BHOPAL,4,5,9
17,AGRA,LUCKNOW,7,5,12
18,AGRA,MUMBAI,15,16,31
19,AHMEDABAD,AMRITSAR,4,4,8
20,AHMEDABAD,BAGDOGRA,37,34,71
21,AHMEDABAD,BELGAUM,7,7,14
22,AHMEDABAD,BENGALURU,283,259,542
23,AHMEDABAD,BHOPAL,18,20,38
25,AHMEDABAD,CHANDIGARH,87,82,169
26,AHMEDABAD,CHENNAI,97,91,188
27,AHMEDABAD,COIMBATORE,3,3,6
28,AHMEDABAD,DABOLIM,188,196,384
29,AHMEDABAD,DEHRA DUN,24,24,48
30,AHMEDABAD,DELHI,698,671,1369
32,AHMEDABAD,GWALIOR,15,15,30
33,AHMEDABAD,HYDERABAD,150,149,299
34,AHMEDABAD,INDORE,32,31,63
35,AHMEDABAD,JAIPUR,44,44,88
37,AHMEDABAD,KOCHI,10,8,18
38,AHMEDABAD,KOLKATA,155,146,301
39,AHMEDABAD,LUCKNOW,86,77,163
40,AHMEDABAD,MUMBAI,448,446,894
41,AHMEDABAD,NAGPUR,20,19,39
42,AHMEDABAD,NASIK,7,7,14
43,AHMEDABAD,PATNA,46,43,89
44,AHMEDABAD,PUNE,105,104,209
45,AHMEDABAD,UDAIPUR,7,7,14
46,AHMEDABAD,VARANASI,21,20,41
47,AHMEDABAD,VISAKHAPATNAM,1,2,3
48,AIZAWL,DELHI,18,18,36
49,AIZAWL,GUWAHATI,34,30,64
50,AIZAWL,IMPHAL,5,5,10
51,AIZAWL,KOLKATA,55,46,101
52,AIZAWL,MUMBAI,1,1,2
53,AIZAWL,SHILLONG,6,4,10
54,AJMER,DELHI,19,18,37
55,AJMER,HYDERABAD,23,24,47
56,AJMER,INDORE,6,6,12
58,AJMER,MUMBAI,16,16,32
59,AJMER,SURAT,5,5,10
60,ALLAHABAD,BENGALURU,43,42,85
61,ALLAHABAD,BHOPAL,13,13,26
62,ALLAHABAD,BHUBANESWAR,15,19,34
63,ALLAHABAD,BILASPUR,4,4,8
64,ALLAHABAD,DEHRA DUN,12,14,26
65,ALLAHABAD,DELHI,48,48,96
66,ALLAHABAD,GORAKHPUR,9,7,16
67,ALLAHABAD,INDORE,15,13,28
68,ALLAHABAD,LUCKNOW,2,2,4
69,ALLAHABAD,MUMBAI,44,45,89
70,ALLAHABAD,PUNE,26,28,54
71,ALLAHABAD,RAIPUR,18,17,35
72,AMRITSAR,BENGALURU,27,31,58
73,AMRITSAR,CHENNAI,1,1,2
74,AMRITSAR,DABOLIM,6,8,14
75,AMRITSAR,DELHI,346,347,693
76,AMRITSAR,GUWAHATI,5,4,9
77,AMRITSAR,HYDERABAD,5,4,9
78,AMRITSAR,JAIPUR,16,15,31
81,AMRITSAR,KOLKATA,39,40,79
82,AMRITSAR,LUCKNOW,3,2,5
83,AMRITSAR,MUMBAI,155,152,307
84,AMRITSAR,NANDED,5,4,9
85,AMRITSAR,PATNA,15,15,30
86,AMRITSAR,PUNE,18,19,37
87,AMRITSAR,SRINAGAR,50,42,92
88,AURANGABAD,DELHI,65,61,126
89,AURANGABAD,HYDERABAD,21,19,40
90,AURANGABAD,MUMBAI,56,59,115
91,BAGDOGRA,BENGALURU,140,125,265
93,BAGDOGRA,CHENNAI,31,27,58
94,BAGDOGRA,DELHI,444,429,873
95,BAGDOGRA,DIBRUGARH,29,27,56
97,BAGDOGRA,HYDERABAD,49,50,99
98,BAGDOGRA,JAIPUR,23,19,42
99,BAGDOGRA,KOLKATA,305,308,613
100,BAGDOGRA,MUMBAI,91,84,175
101,BAREILLY,BENGALURU,30,28,58
102,BAREILLY,DELHI,16,14,30
103,BAREILLY,MUMBAI,28,27,55
104,BELGAUM,BENGALURU,21,21,42
105,BELGAUM,DELHI,23,20,43
106,BELGAUM,HYDERABAD,34,33,67
107,BELGAUM,INDORE,6,6,12
108,BELGAUM,JODHPUR,6,5,11
109,BELGAUM,MUMBAI,30,28,58
110,BELGAUM,NASIK,4,4,8
111,BELGAUM,PUNE,9,8,17
112,BELGAUM,SURAT,5,5,10
113,BELGAUM,TIRUPATI,4,3,7
114,BENGALURU,BHOPAL,37,43,80
115,BENGALURU,BHUBANESWAR,182,203,385
116,BENGALURU,CHANDIGARH,125,117,242
117,BENGALURU,CHENNAI,336,364,700
118,BENGALURU,COIMBATORE,95,108,203
119,BENGALURU,DABOLIM,435,454,889
120,BENGALURU,DARBHANGA,53,57,110
121,BENGALURU,DEHRA DUN,44,42,86
122,BENGALURU,DELHI,1381,1425,2806
123,BENGALURU,DIBRUGARH,16,17,33
124,BENGALURU,DIMAPUR,7,6,13
125,BENGALURU,DURGAPUR,40,44,84
126,BENGALURU,GORAKHPUR,16,16,32
127,BENGALURU,GUWAHATI,175,192,367
128,BENGALURU,GWALIOR,20,20,40
129,BENGALURU,HUBLI,46,49,95
130,BENGALURU,HYDERABAD,574,593,1167
131,BENGALURU,IMPHAL,3,4,7
132,BENGALURU,INDORE,83,90,173
133,BENGALURU,JABALPUR,21,22,43
134,BENGALURU,JAIPUR,201,201,402
135,BENGALURU,JAMMU,1,1,2
136,BENGALURU,JAMNAGAR,6,6,12
137,BENGALURU,JHARSUGUDA,9,12,21
138,BENGALURU,JODHPUR,32,35,67
139,BENGALURU,JORHAT,4,4,8
140,BENGALURU,KADAPA,1,1,2
141,BENGALURU,"KALABURAGI, KARNATAKA",27,28,55
142,BENGALURU,KANNUR,28,30,58
143,BENGALURU,KANPUR,35,38,73
144,BENGALURU,KOCHI,361,360,721
145,BENGALURU,KOLHAPUR,4,5,9
146,BENGALURU,KOLKATA,642,681,1323
147,BENGALURU,KOZHIKODE,31,42,73
148,BENGALURU,KURNOOL,5,6,11
149,BENGALURU,LUCKNOW,183,179,362
150,BENGALURU,MADURAI,60,63,123
151,BENGALURU,MANGALORE,175,174,349
152,BENGALURU,MUMBAI,1031,1048,2079
153,BENGALURU,MYSORE,6,9,15
154,BENGALURU,NAGPUR,95,96,191
155,BENGALURU,PATNA,205,198,403
156,BENGALURU,PONDICHERRY,2,2,4
157,BENGALURU,PORT BLAIR,53,49,102
158,BENGALURU,PUNE,416,395,811
159,BENGALURU,RAIPUR,64,71,135
160,BENGALURU,RAJAHMUNDRY,24,26,50
161,BENGALURU,RAJKOT,36,38,74
162,BENGALURU,RANCHI,134,150,284
163,BENGALURU,SHIRDI,50,47,97
164,BENGALURU,SILCHAR,16,15,31
165,BENGALURU,SRINAGAR,15,15,30
166,BENGALURU,SURAT,54,56,110
167,BENGALURU,TIRUCHIRAPALLY,37,34,71
168,BENGALURU,TIRUPATI,13,13,26
169,BENGALURU,TRIVANDRUM,133,143,276
170,BENGALURU,TUTICORIN,9,10,19
171,BENGALURU,UDAIPUR,34,40,74
172,BENGALURU,VADODARA,43,45,88
173,BENGALURU,VARANASI,120,126,246
174,BENGALURU,VIJAYAWADA,78,86,164
175,BENGALURU,VISAKHAPATNAM,136,144,280
176,BHAVNAGAR,MUMBAI,10,11,21
177,BHOPAL,CHENNAI,1,2,3
178,BHOPAL,DELHI,184,175,359
179,BHOPAL,HYDERABAD,21,18,39
180,BHOPAL,KOCHI,4,5,9
181,BHOPAL,MUMBAI,137,137,274
182,BHOPAL,PUNE,16,13,29
183,BHOPAL,RAIPUR,11,11,22
184,BHUBANESWAR,CHANDIGARH,1,1,2
185,BHUBANESWAR,CHENNAI,49,45,94
186,BHUBANESWAR,DELHI,417,407,824
187,BHUBANESWAR,HYDERABAD,126,122,248
188,BHUBANESWAR,JAIPUR,22,22,44
189,BHUBANESWAR,JHARSUGUDA,13,12,25
190,BHUBANESWAR,KOLKATA,195,192,387
191,BHUBANESWAR,LUCKNOW,7,6,13
192,BHUBANESWAR,MUMBAI,190,181,371
193,BHUBANESWAR,PATNA,5,6,11
194,BHUBANESWAR,PUNE,49,40,89
195,BHUBANESWAR,RAIPUR,16,14,30
196,BHUBANESWAR,RANCHI,4,4,8
197,BHUBANESWAR,SURAT,2,3,5
198,BHUBANESWAR,VARANASI,18,18,36
199,BHUJ,MUMBAI,11,11,22
200,BIKANER,DELHI,11,11,22
201,BILASPUR,DELHI,5,5,10
202,BILASPUR,JABALPUR,3,3,6
203,CHANDIGARH,CHENNAI,7,8,15
204,CHANDIGARH,DABOLIM,56,60,116
205,CHANDIGARH,DELHI,271,285,556
206,CHANDIGARH,DHARAMSALA,9,10,19
207,CHANDIGARH,GUWAHATI,8,8,16
208,CHANDIGARH,HYDERABAD,91,103,194
209,CHANDIGARH,JAIPUR,36,33,69
210,CHANDIGARH,KOLKATA,32,35,67
211,CHANDIGARH,KULLU,6,2,8
212,CHANDIGARH,LEH,31,15,46
213,CHANDIGARH,LUCKNOW,28,31,59
214,CHANDIGARH,MUMBAI,382,403,785
215,CHANDIGARH,PATNA,29,36,65
216,CHANDIGARH,PUNE,44,41,85
217,CHANDIGARH,SRINAGAR,95,86,181
218,CHANDIGARH,VADODARA,3,4,7
219,CHENNAI,COIMBATORE,287,284,571
220,CHENNAI,DABOLIM,69,65,134
221,CHENNAI,DARBHANGA,3,2,5
222,CHENNAI,DEHRA DUN,6,5,11
223,CHENNAI,DELHI,811,823,1634
224,CHENNAI,DIBRUGARH,6,7,13
225,CHENNAI,DURGAPUR,37,37,74
227,CHENNAI,GUWAHATI,117,139,256
228,CHENNAI,HUBLI,13,15,28
229,CHENNAI,HYDERABAD,464,463,927
230,CHENNAI,INDORE,13,17,30
231,CHENNAI,JAIPUR,70,61,131
232,CHENNAI,JODHPUR,56,55,111
233,CHENNAI,KADAPA,1,1,2
234,CHENNAI,KANNUR,19,17,36
235,CHENNAI,KOCHI,136,138,274
236,CHENNAI,KOLKATA,352,351,703
237,CHENNAI,KOZHIKODE,18,18,36
238,CHENNAI,KURNOOL,5,6,11
239,CHENNAI,LUCKNOW,35,37,72
240,CHENNAI,MADURAI,127,126,253
241,CHENNAI,MANGALORE,20,19,39
242,CHENNAI,MUMBAI,618,606,1224
243,CHENNAI,MYSORE,13,14,27
244,CHENNAI,NAGPUR,20,24,44
245,CHENNAI,PATNA,40,50,90
246,CHENNAI,PORT BLAIR,120,125,245
247,CHENNAI,PUNE,169,174,343
248,CHENNAI,RAIPUR,26,25,51
249,CHENNAI,RAJAHMUNDRY,16,18,34
250,CHENNAI,RANCHI,35,39,74
251,CHENNAI,SHIRDI,51,48,99
252,CHENNAI,SRINAGAR,3,1,4
253,CHENNAI,SURAT,5,5,10
254,CHENNAI,TIRUCHIRAPALLY,50,44,94
255,CHENNAI,TRIVANDRUM,64,65,129
256,CHENNAI,TUTICORIN,60,58,118
257,CHENNAI,VADODARA,2,2,4
258,CHENNAI,VARANASI,59,53,112
259,CHENNAI,VIJAYAWADA,31,32,63
260,CHENNAI,VISAKHAPATNAM,71,80,151
262,COIMBATORE,DELHI,104,101,205
263,COIMBATORE,GUWAHATI,3,2,5
264,COIMBATORE,HYDERABAD,127,122,249
265,COIMBATORE,JAIPUR,5,3,8
267,COIMBATORE,MUMBAI,164,153,317
268,COIMBATORE,PUNE,18,11,29
269,COIMBATORE,SURAT,1,1,2
270,COIMBATORE,TIRUPATI,1,1,2
272,DABOLIM,DELHI,1064,1025,2089
274,DABOLIM,HYDERABAD,442,411,853
275,DABOLIM,INDORE,33,33,66
276,DABOLIM,JAIPUR,60,56,116
277,DABOLIM,KANNUR,10,14,24
278,DABOLIM,KOCHI,25,25,50
279,DABOLIM,KOLKATA,98,94,192
280,DABOLIM,LUCKNOW,51,49,100
281,DABOLIM,MUMBAI,970,890,1860
282,DABOLIM,MYSORE,11,11,22
283,DABOLIM,NAGPUR,26,23,49
284,DABOLIM,PUNE,113,104,217
285,DABOLIM,RAIPUR,14,12,26
286,DABOLIM,RAJKOT,22,22,44
287,DABOLIM,SURAT,58,45,103
289,DARBHANGA,DELHI,90,85,175
290,DARBHANGA,HYDERABAD,24,25,49
291,DARBHANGA,KOLKATA,14,15,29
292,DARBHANGA,MUMBAI,46,49,95
293,DEHRA DUN,DELHI,243,249,492
294,DEHRA DUN,GUWAHATI,1,1,2
295,DEHRA DUN,HYDERABAD,5,5,10
296,DEHRA DUN,JAIPUR,22,18,40
297,DEHRA DUN,KOLKATA,3,2,5
298,DEHRA DUN,LUCKNOW,35,36,71
299,DEHRA DUN,MUMBAI,152,160,312
300,DEHRA DUN,PANTNAGAR,6,6,12
301,DEHRA DUN,PUNE,1,1,2
302,DEHRA DUN,VARANASI,11,12,23
303,DELHI,DHARAMSALA,69,60,129
304,DELHI,DIBRUGARH,99,84,183
305,DELHI,DIMAPUR,28,34,62
306,DELHI,DURGAPUR,37,40,77
307,DELHI,GAYA,25,25,50
308,DELHI,GORAKHPUR,120,110,230
309,DELHI,GUWAHATI,556,570,1126
310,DELHI,GWALIOR,10,13,23
311,DELHI,HYDERABAD,924,925,1849
312,DELHI,IMPHAL,75,86,161
313,DELHI,INDORE,308,309,617
314,DELHI,JABALPUR,74,68,142
315,DELHI,JAIPUR,203,191,394
316,DELHI,JAISALMER,27,28,55
317,DELHI,JAMMU,400,384,784
318,DELHI,JHARSUGUDA,53,52,105
319,DELHI,JODHPUR,115,120,235
320,DELHI,JORHAT,8,9,17
321,DELHI,KANDLA,21,20,41
322,DELHI,KANNUR,6,8,14
323,DELHI,KANPUR,22,21,43
324,DELHI,KHAJURAHO,5,5,10
325,DELHI,KOCHI,331,310,641
326,DELHI,KOLKATA,1055,1071,2126
327,DELHI,KOZHIKODE,69,67,136
328,DELHI,KULLU,9,3,12
329,DELHI,LEH,384,149,533
330,DELHI,LUCKNOW,435,455,890
331,DELHI,MADURAI,6,7,13
332,DELHI,MANGALORE,1,1,2
333,DELHI,MUMBAI,2060,2029,4089
334,DELHI,NAGPUR,183,197,380
335,DELHI,NASIK,5,5,10
336,DELHI,PAKYONG,19,16,35
337,DELHI,PANTNAGAR,5,5,10
338,DELHI,PATNA,670,627,1297
339,DELHI,PORT BLAIR,31,32,63
340,DELHI,PUNE,907,874,1781
341,DELHI,RAIPUR,292,289,581
342,DELHI,RAJKOT,97,99,196
343,DELHI,RANCHI,390,374,764
344,DELHI,SHIRDI,71,72,143
345,DELHI,SILCHAR,12,13,25
346,DELHI,SRINAGAR,1167,1063,2230
347,DELHI,SURAT,235,234,469
348,DELHI,TIRUCHIRAPALLY,2,2,4
349,DELHI,TIRUPATI,26,20,46
350,DELHI,TRIVANDRUM,85,90,175
351,DELHI,UDAIPUR,192,203,395
352,DELHI,VADODARA,148,170,318
353,DELHI,VARANASI,342,328,670
354,DELHI,VIJAYAWADA,64,65,129
355,DELHI,VISAKHAPATNAM,176,171,347
356,DELHI,Kushinagar International Airport,14,13,27
357,DHARAMSALA,JAIPUR,1,2,3
358,DIBRUGARH,DIMAPUR,2,1,3
359,DIBRUGARH,GUWAHATI,25,24,49
360,DIBRUGARH,IMPHAL,7,7,14
361,DIBRUGARH,KOLKATA,99,84,183
362,DIBRUGARH,MUMBAI,4,4,8
363,DIBRUGARH,SHILLONG,6,5,11
364,DIMAPUR,GUWAHATI,10,7,17
366,DIMAPUR,IMPHAL,10,12,22
367,DIMAPUR,KOLKATA,55,40,95
368,DIMAPUR,MUMBAI,1,1,2
369,DIMAPUR,SHILLONG,3,2,5
370,DIU,MUMBAI,18,17,35
371,DURGAPUR,GUWAHATI,1,2,3
372,DURGAPUR,HYDERABAD,29,23,52
373,DURGAPUR,MUMBAI,39,35,74
374,DURGAPUR,TRIVANDRUM,1,1,2
376,GAYA,KOLKATA,10,9,19
377,GAYA,MUMBAI,1,1,2
378,GHAZIABAD,HUBLI,7,8,15
379,GHAZIABAD,"KALABURAGI, KARNATAKA",6,6,12
380,GORAKHPUR,HYDERABAD,32,33,65
382,GORAKHPUR,KANPUR,1,1,2
383,GORAKHPUR,KOLKATA,10,9,19
384,GORAKHPUR,LUCKNOW,4,4,8
385,GORAKHPUR,MUMBAI,73,79,152
386,GORAKHPUR,VARANASI,1,1,2
387,GUWAHATI,HYDERABAD,43,44,87
388,GUWAHATI,IMPHAL,139,182,321
389,GUWAHATI,JAIPUR,41,41,82
390,GUWAHATI,JODHPUR,2,1,3
391,GUWAHATI,JORHAT,9,11,20
392,GUWAHATI,KOLKATA,366,378,744
393,GUWAHATI,LILABARI,6,7,13
394,GUWAHATI,LUCKNOW,39,34,73
395,GUWAHATI,MUMBAI,66,59,125
396,GUWAHATI,PASIGHAT,3,4,7
397,GUWAHATI,PATNA,18,18,36
398,GUWAHATI,PUNE,45,42,87
399,GUWAHATI,RUPSI,8,6,14
400,GUWAHATI,SHILLONG,2,1,3
401,GUWAHATI,SILCHAR,29,29,58
402,GUWAHATI,TEZPUR,2,1,3
403,GUWAHATI,TEZU,4,6,10
404,GUWAHATI,UDAIPUR,2,1,3
405,GUWAHATI,VARANASI,2,2,4
406,GWALIOR,HYDERABAD,13,16,29
407,GWALIOR,INDORE,10,13,23
408,GWALIOR,JAIPUR,1,1,2
409,GWALIOR,JAMMU,12,10,22
410,GWALIOR,KOLKATA,13,13,26
411,GWALIOR,MUMBAI,15,14,29
412,HUBLI,KANNUR,5,6,11
413,HUBLI,MUMBAI,19,18,37
414,HUBLI,TIRUPATI,3,3,6
415,HYDERABAD,IMPHAL,2,3,5
416,HYDERABAD,INDORE,73,74,147
417,HYDERABAD,JABALPUR,17,20,37
418,HYDERABAD,JAGDALPUR,12,12,24
419,HYDERABAD,JAIPUR,154,142,296
421,HYDERABAD,JAMNAGAR,6,5,11
422,HYDERABAD,JHARSUGUDA,20,20,40
423,HYDERABAD,JODHPUR,42,41,83
424,HYDERABAD,KADAPA,2,2,4
425,HYDERABAD,KANNUR,15,17,32
426,HYDERABAD,KOCHI,170,156,326
427,HYDERABAD,KOLHAPUR,29,27,56
428,HYDERABAD,KOLKATA,423,380,803
429,HYDERABAD,KOZHIKODE,16,18,34
430,HYDERABAD,LUCKNOW,92,96,188
431,HYDERABAD,MADURAI,46,47,93
432,HYDERABAD,MANGALORE,51,49,100
433,HYDERABAD,MUMBAI,526,516,1042
434,HYDERABAD,MYSORE,27,26,53
435,HYDERABAD,NAGPUR,19,20,39
436,HYDERABAD,PATNA,99,76,175
437,HYDERABAD,PONDICHERRY,3,3,6
438,HYDERABAD,PORT BLAIR,13,15,28
439,HYDERABAD,PUNE,127,142,269
440,HYDERABAD,RAIPUR,74,76,150
441,HYDERABAD,RAJAHMUNDRY,77,77,154
442,HYDERABAD,RANCHI,62,67,129
443,HYDERABAD,SHIRDI,66,67,133
444,HYDERABAD,SRINAGAR,6,6,12
445,HYDERABAD,SURAT,46,44,90
446,HYDERABAD,TIRUCHIRAPALLY,21,17,38
447,HYDERABAD,TIRUPATI,235,241,476
448,HYDERABAD,TRIVANDRUM,47,44,91
449,HYDERABAD,UDAIPUR,37,40,77
450,HYDERABAD,VADODARA,46,50,96
451,HYDERABAD,VARANASI,98,100,198
452,HYDERABAD,VIJAYAWADA,99,93,192
453,HYDERABAD,VISAKHAPATNAM,291,278,569
454,IMPHAL,KOLKATA,160,118,278
455,IMPHAL,MUMBAI,3,4,7
456,IMPHAL,SHILLONG,9,8,17
457,INDORE,JABALPUR,12,14,26
458,INDORE,JAIPUR,20,21,41
459,INDORE,JAMMU,3,3,6
460,INDORE,JODHPUR,8,8,16
461,INDORE,KOLKATA,40,33,73
462,INDORE,LUCKNOW,19,20,39
463,INDORE,MUMBAI,207,199,406
464,INDORE,NAGPUR,17,17,34
465,INDORE,PUNE,48,50,98
466,INDORE,RAIPUR,42,44,86
467,INDORE,SURAT,5,7,12
468,JABALPUR,MUMBAI,36,34,70
469,JABALPUR,PUNE,19,17,36
470,JAGDALPUR,RAIPUR,11,12,23
471,JAIPUR,JAISALMER,13,14,27
472,JAIPUR,KOLKATA,187,191,378
473,JAIPUR,LUCKNOW,18,19,37
474,JAIPUR,MUMBAI,426,433,859
475,JAIPUR,PATNA,3,4,7
476,JAIPUR,PUNE,92,75,167
477,JAIPUR,SURAT,28,26,54
478,JAIPUR,UDAIPUR,26,24,50
479,JAIPUR,VADODARA,11,12,23
480,JAIPUR,VARANASI,3,4,7
481,JAISALMER,MUMBAI,1,1,2
484,JAMMU,LEH,36,26,62
485,JAMMU,MUMBAI,38,86,124
486,JAMMU,SRINAGAR,234,139,373
487,JAMMU,VARANASI,1,1,2
488,JAMNAGAR,MUMBAI,33,33,66
489,JHARSUGUDA,KOLKATA,25,23,48
490,JHARSUGUDA,RAIPUR,9,7,16
491,JODHPUR,KOLKATA,11,11,22
492,JODHPUR,MUMBAI,134,135,269
493,JORHAT,KOLKATA,23,25,48
494,KADAPA,VIJAYAWADA,1,1,2
495,KADAPA,VISAKHAPATNAM,1,1,2
496,"KALABURAGI, KARNATAKA",TIRUPATI,6,5,11
497,KANDLA,MUMBAI,30,31,61
498,KANNUR,KOCHI,19,19,38
499,KANNUR,KOZHIKODE,1,1,2
500,KANNUR,MUMBAI,24,28,52
501,KANNUR,TRIVANDRUM,17,16,33
502,KANPUR,MUMBAI,49,45,94
503,KOCHI,KOLKATA,39,37,76
504,KOCHI,MUMBAI,306,291,597
505,KOCHI,MYSORE,9,10,19
506,KOCHI,PUNE,39,40,79
508,KOCHI,RANCHI,5,4,9
509,KOCHI,TRIVANDRUM,16,17,33
511,KOLHAPUR,TIRUPATI,11,12,23
512,KOLKATA,LILABARI,11,13,24
513,KOLKATA,LUCKNOW,83,81,164
514,KOLKATA,MANGALORE,2,4,6
515,KOLKATA,MUMBAI,587,563,1150
516,KOLKATA,NAGPUR,21,22,43
517,KOLKATA,PAKYONG,19,17,36
519,KOLKATA,PATNA,103,100,203
520,KOLKATA,PORT BLAIR,125,130,255
521,KOLKATA,PUNE,66,62,128
522,KOLKATA,RAIPUR,57,64,121
523,KOLKATA,RANCHI,44,41,85
524,KOLKATA,RUPSI,12,13,25
525,KOLKATA,SHILLONG,18,17,35
526,KOLKATA,SILCHAR,101,109,210
527,KOLKATA,SRINAGAR,11,9,20
528,KOLKATA,SURAT,50,50,100
530,KOLKATA,TRIVANDRUM,1,1,2
531,KOLKATA,UDAIPUR,11,12,23
532,KOLKATA,VARANASI,47,47,94
533,KOLKATA,VISAKHAPATNAM,47,44,91
534,KOLKATA,Kushinagar International Airport,1,2,3
535,KOZHIKODE,MUMBAI,45,43,88
536,KURNOOL,VISAKHAPATNAM,6,7,13
537,LEH,SRINAGAR,17,14,31
538,LUCKNOW,MUMBAI,231,252,483
539,LUCKNOW,NAGPUR,18,16,34
540,LUCKNOW,PATNA,31,33,64
541,LUCKNOW,PUNE,47,42,89
542,LUCKNOW,RAIPUR,13,14,27
543,LUCKNOW,RANCHI,23,28,51
544,LUCKNOW,SRINAGAR,2,2,4
545,LUCKNOW,UDAIPUR,1,1,2
547,MADURAI,MUMBAI,35,35,70
548,MADURAI,TIRUPATI,7,6,13
549,MADURAI,VIJAYAWADA,1,1,2
550,MANGALORE,MUMBAI,189,210,399
551,MANGALORE,PUNE,2,2,4
553,MUMBAI,NAGPUR,324,336,660
554,MUMBAI,NANDED,3,3,6
555,MUMBAI,PATNA,158,156,314
556,MUMBAI,PORBANDAR,3,2,5
558,MUMBAI,PUNE,4,2,6
559,MUMBAI,RAIPUR,146,142,288
560,MUMBAI,RAJKOT,125,124,249
561,MUMBAI,RANCHI,123,144,267
562,MUMBAI,SILCHAR,1,1,2
563,MUMBAI,SRINAGAR,95,141,236
564,MUMBAI,SURAT,15,14,29
565,MUMBAI,TIRUPATI,18,17,35
566,MUMBAI,TRIVANDRUM,64,77,141
567,MUMBAI,UDAIPUR,210,210,420
568,MUMBAI,VADODARA,111,112,223
569,MUMBAI,VARANASI,254,242,496
570,MUMBAI,VISAKHAPATNAM,51,61,112
571,MUMBAI,Sindhudurg Airport,17,16,33
572,NAGPUR,PUNE,154,141,295
573,NAGPUR,RAIPUR,2,1,3
574,NASIK,PUNE,7,7,14
575,PASIGHAT,TEZPUR,1,1,2
576,PATNA,PUNE,38,37,75
577,PATNA,RANCHI,26,29,55
578,PATNA,VARANASI,1,1,2
579,PORT BLAIR,VISAKHAPATNAM,8,8,16
580,PUNE,RAIPUR,15,15,30
581,PUNE,RANCHI,7,8,15
582,PUNE,TIRUPATI,2,2,4
583,PUNE,TRIVANDRUM,3,4,7
584,PUNE,VISAKHAPATNAM,1,1,2
585,RAIPUR,SRINAGAR,1,1,2
586,RAIPUR,TRIVANDRUM,1,1,2
588,RAJAHMUNDRY,TIRUPATI,1,1,2
589,RAJAHMUNDRY,VISAKHAPATNAM,5,6,11
590,SHILLONG,SILCHAR,4,5,9
591,SHIRDI,TIRUPATI,1,1,2
593,TIRUCHIRAPALLY,TIRUPATI,1,1,2
594,TIRUPATI,VIJAYAWADA,10,14,24
595,TIRUPATI,VISAKHAPATNAM,25,27,52
596,VIJAYAWADA,VISAKHAPATNAM,17,16,33
597,HYDERABAD,Gondia Airport,6,7,13
598,Gondia Airport,INDORE,7,8,15
