S.No.,CITY 1,CITY 2,AVG FLIGHTS TO CITY 2,AVG FLIGHTS FROM CITY 2,TOTAL AVG FLIGHTS
1,AGARTALA,VISAKHAPATNAM,1,1,2
2,AGARTALA,AHMEDABAD,4,3,7
3,AGARTALA,AIZAWL,7,7,14
4,AGARTALA,BENGALURU,29,25,54
5,AGARTALA,CHENNAI,18,10,28
6,AGARTALA,DELHI,49,49,98
7,AGARTALA,DIBRUGARH,11,15,26
8,AGARTALA,GUWAHATI,93,101,194
9,AGARTALA,IMPHAL,13,16,29
10,AGARTALA,KOLKATA,250,260,510
11,AGARTALA,SHILLONG,6,6,12
12,AGATTI ISLAND,BENGALURU,1,1,2
13,AGATTI ISLAND,KOCHI,15,19,34
14,AGRA,AHMEDABAD,9,7,16
15,AGRA,BENGALURU,21,20,41
16,AGRA,BHOPAL,3,3,6
17,AGRA,LUCKNOW,5,4,9
18,AGRA,MUMBAI,14,11,25
19,AHMEDABAD,AMRITSAR,7,6,13
20,AHMEDABAD,BAGDOGRA,35,44,79
21,AHMEDABAD,BELGAUM,8,9,17
22,AHMEDABAD,BENGALURU,410,413,823
23,AHMEDABAD,BHOPAL,17,19,36
24,AHMEDABAD,BHUBANESWAR,22,23,45
25,AHMEDABAD,BHUJ,7,7,14
26,AHMEDABAD,CHANDIGARH,85,93,178
27,AHMEDABAD,CHENNAI,123,131,254
28,AHMEDABAD,COIMBATORE,9,10,19
29,AHMEDABAD,DABOLIM,158,167,325
30,AHMEDABAD,DEHRA DUN,38,36,74
31,AHMEDABAD,DELHI,860,936,1796
32,AHMEDABAD,DURGAPUR,2,2,4
33,AHMEDABAD,HYDERABAD,181,199,380
34,AHMEDABAD,INDORE,20,23,43
35,AHMEDABAD,JAIPUR,95,107,202
36,AHMEDABAD,JODHPUR,15,16,31
37,AHMEDABAD,KOCHI,45,45,90
38,AHMEDABAD,KOLHAPUR,9,8,17
39,AHMEDABAD,KOLKATA,151,184,335
40,AHMEDABAD,JAISALMER,8,9,17
41,AHMEDABAD,JAMMU,16,22,38
42,AHMEDABAD,LUCKNOW,84,105,189
43,AHMEDABAD,MUMBAI,832,842,1674
44,AHMEDABAD,NAGPUR,39,40,79
45,AHMEDABAD,PATNA,45,58,103
46,AHMEDABAD,PUNE,182,179,361
47,AHMEDABAD,RAIPUR,19,19,38
48,AHMEDABAD,RANCHI,26,28,54
49,AHMEDABAD,PORT BLAIR,1,26,27
50,AHMEDABAD,TRIVANDRUM,4,4,8
51,AHMEDABAD,VARANASI,62,79,141
52,AHMEDABAD,VISAKHAPATNAM,4,4,8
53,AIZAWL,DELHI,17,20,37
54,AIZAWL,GUWAHATI,53,51,104
55,AIZAWL,IMPHAL,8,8,16
56,AIZAWL,KOLKATA,60,60,120
57,AIZAWL,MUMBAI,3,3,6
58,AIZAWL,SHILLONG,6,6,12
59,AIZAWL,DIMAPUR,1,1,2
60,AJMER,INDORE,2,2,4
61,AJMER,SURAT,3,3,6
62,ALLAHABAD,BENGALURU,41,41,82
63,ALLAHABAD,BHOPAL,8,8,16
64,ALLAHABAD,BHUBANESWAR,16,16,32
65,ALLAHABAD,BILASPUR,5,4,9
66,ALLAHABAD,DEHRA DUN,12,14,26
67,ALLAHABAD,DELHI,53,52,105
68,ALLAHABAD,GORAKHPUR,11,6,17
69,ALLAHABAD,INDORE,17,15,32
70,ALLAHABAD,LUCKNOW,9,12,21
71,ALLAHABAD,MUMBAI,41,41,82
72,ALLAHABAD,PUNE,14,14,28
73,ALLAHABAD,RAIPUR,18,14,32
74,AMRITSAR,BENGALURU,33,38,71
75,AMRITSAR,CHENNAI,3,4,7
76,AMRITSAR,DABOLIM,29,21,50
77,AMRITSAR,DEHRA DUN,27,1,28
78,AMRITSAR,DELHI,329,340,669
79,AMRITSAR,GUWAHATI,1,1,2
80,AMRITSAR,HYDERABAD,2,3,5
81,AMRITSAR,JAIPUR,27,1,28
82,AMRITSAR,KOLKATA,33,33,66
83,AMRITSAR,LUCKNOW,15,15,30
84,AMRITSAR,MUMBAI,161,156,317
85,AMRITSAR,PATNA,7,7,14
86,AMRITSAR,PUNE,41,35,76
87,AMRITSAR,SRINAGAR,30,35,65
88,AMRITSAR,CHANDIGARH,1,1,2
89,AURANGABAD,DELHI,84,88,172
90,AURANGABAD,HYDERABAD,38,33,71
91,AURANGABAD,MUMBAI,74,60,134
92,BAGDOGRA,GUWAHATI,40,26,66
93,BAGDOGRA,BENGALURU,189,159,348
94,BAGDOGRA,CHENNAI,36,33,69
95,BAGDOGRA,DELHI,385,422,807
96,BAGDOGRA,DIBRUGARH,30,25,55
97,BAGDOGRA,HYDERABAD,47,44,91
98,BAGDOGRA,KOLKATA,230,217,447
99,BAGDOGRA,MUMBAI,98,90,188
100,BAREILLY,BENGALURU,18,17,35
101,BAREILLY,DELHI,13,12,25
102,BAREILLY,MUMBAI,27,25,52
103,BELGAUM,BENGALURU,36,34,70
104,BELGAUM,DELHI,21,22,43
105,BELGAUM,HYDERABAD,18,18,36
106,BELGAUM,INDORE,4,4,8
107,BELGAUM,JODHPUR,4,4,8
108,BELGAUM,MUMBAI,10,10,20
109,BELGAUM,NAGPUR,2,3,5
110,BELGAUM,SURAT,4,4,8
111,BELGAUM,TIRUPATI,3,4,7
112,BENGALURU,BHOPAL,39,42,81
113,BENGALURU,BHUBANESWAR,228,261,489
114,BENGALURU,BIDAR ,4,5,9
115,BENGALURU,CHANDIGARH,135,156,291
116,BENGALURU,CHENNAI,506,563,1069
117,BENGALURU,COIMBATORE,118,136,254
118,BENGALURU,DABOLIM,393,399,792
119,BENGALURU,DARBHANGA,54,52,106
120,BENGALURU,DEHRA DUN,41,40,81
121,BENGALURU,DELHI,1771,1892,3663
122,BENGALURU,DIMAPUR,9,4,13
123,BENGALURU,DURGAPUR,40,50,90
124,BENGALURU,GORAKHPUR,10,12,22
125,BENGALURU,GUWAHATI,273,266,539
126,BENGALURU,GWALIOR,17,21,38
127,BENGALURU,HUBLI,40,42,82
128,BENGALURU,HYDERABAD,684,737,1421
129,BENGALURU,IMPHAL,4,3,7
130,BENGALURU,INDORE,103,122,225
131,BENGALURU,JABALPUR,7,10,17
132,BENGALURU,JAIPUR,225,247,472
133,BENGALURU,JAMMU,8,5,13
134,BENGALURU,JAMNAGAR,5,5,10
135,BENGALURU,JODHPUR,31,35,66
136,BENGALURU,JORHAT,3,4,7
137,BENGALURU,KADAPA,2,2,4
138,BENGALURU,KALABURAGI,25,25,50
139,BENGALURU,KANNUR,31,36,67
140,BENGALURU,KANPUR,29,40,69
141,BENGALURU,KOCHI,574,587,1161
142,BENGALURU,KOLKATA,565,597,1162
143,BENGALURU,KOZHIKODE,29,40,69
144,BENGALURU,KURNOOL,3,4,7
145,BENGALURU,LUCKNOW,234,280,514
146,BENGALURU,MADURAI,52,55,107
147,BENGALURU,MANGALORE,213,219,432
148,BENGALURU,MUMBAI,1541,1534,3075
149,BENGALURU,NAGPUR,123,133,256
150,BENGALURU,PATNA,169,193,362
151,BENGALURU,PONDICHERRY,6,6,12
152,BENGALURU,PORT BLAIR,49,42,91
153,BENGALURU,PUNE,625,636,1261
154,BENGALURU,RAIPUR,90,91,181
155,BENGALURU,RAJAHMUNDRY,34,38,72
156,BENGALURU,RAJKOT,27,28,55
157,BENGALURU,RANCHI,147,204,351
158,BENGALURU,SHIRDI,57,58,115
159,BENGALURU,SRINAGAR,7,13,20
160,BENGALURU,SURAT,59,50,109
161,BENGALURU,TIRUCHIRAPALLY,42,52,94
162,BENGALURU,TIRUPATI,18,18,36
163,BENGALURU,TRIVANDRUM,190,221,411
164,BENGALURU,TUTICORIN,14,13,27
165,BENGALURU,UDAIPUR,54,57,111
166,BENGALURU,VADODARA,46,45,91
167,BENGALURU,VARANASI,132,139,271
168,BENGALURU,VIJAYAWADA,89,92,181
169,BENGALURU,VISAKHAPATNAM,154,179,333
170,BENGALURU,NASIK,1,1,2
171,BENGALURU,SILCHAR,3,4,7
172,BENGALURU,VIDYANAGAR,10,11,21
173,BHAVNAGAR,MUMBAI,12,12,24
174,BHAVNAGAR,PUNE,12,12,24
175,BHOPAL,DELHI,198,200,398
176,BHOPAL,HYDERABAD,20,20,40
177,BHOPAL,KOCHI,6,7,13
178,BHOPAL,MUMBAI,136,121,257
179,BHOPAL,RAIPUR,9,9,18
180,BHOPAL,UDAIPUR,6,6,12
181,BHUBANESWAR,CHANDIGARH,7,7,14
182,BHUBANESWAR,CHENNAI,69,56,125
183,BHUBANESWAR,DELHI,403,444,847
184,BHUBANESWAR,HYDERABAD,128,125,253
185,BHUBANESWAR,JAIPUR,16,17,33
186,BHUBANESWAR,JHARSUGUDA,12,13,25
187,BHUBANESWAR,KOLKATA,184,213,397
188,BHUBANESWAR,LUCKNOW,11,6,17
189,BHUBANESWAR,MUMBAI,208,185,393
190,BHUBANESWAR,PATNA,28,38,66
191,BHUBANESWAR,PUNE,69,56,125
192,BHUBANESWAR,RAIPUR,18,20,38
193,BHUBANESWAR,RANCHI,14,20,34
194,BHUBANESWAR,VARANASI,19,20,39
195,BHUBANESWAR,JEYPORE,2,2,4
196,BHUJ,MUMBAI,12,13,25
197,BIKANER,DELHI,13,14,27
198,BILASPUR,INDORE,7,5,12
199,BILASPUR,DELHI,6,5,11
200,BILASPUR,JABALPUR,3,3,6
201,CHANDIGARH,INDORE,15,15,30
202,CHANDIGARH,KOCHI,2,2,4
203,CHANDIGARH,CHENNAI,36,35,71
204,CHANDIGARH,DABOLIM,40,40,80
205,CHANDIGARH,DEHRA DUN,27,2,29
206,CHANDIGARH,DELHI,288,284,572
207,CHANDIGARH,DHARAMSALA,7,11,18
208,CHANDIGARH,GUWAHATI,11,8,19
209,CHANDIGARH,HYDERABAD,81,77,158
210,CHANDIGARH,JAIPUR,40,41,81
211,CHANDIGARH,KOLKATA,31,38,69
212,CHANDIGARH,KULLU,2,2,4
213,CHANDIGARH,LEH,11,30,41
214,CHANDIGARH,LUCKNOW,33,38,71
215,CHANDIGARH,MUMBAI,304,288,592
216,CHANDIGARH,PATNA,39,41,80
217,CHANDIGARH,PUNE,38,35,73
218,CHANDIGARH,SRINAGAR,95,113,208
219,CHENNAI,KANPUR,1,1,2
220,CHENNAI,NASIK,2,2,4
221,CHENNAI,COIMBATORE,277,264,541
222,CHENNAI,DABOLIM,84,79,163
223,CHENNAI,DARBHANGA,4,3,7
224,CHENNAI,DEHRA DUN,9,8,17
225,CHENNAI,DELHI,715,749,1464
226,CHENNAI,DIBRUGARH,9,8,17
227,CHENNAI,DURGAPUR,35,36,71
228,CHENNAI,GUWAHATI,121,118,239
229,CHENNAI,HUBLI,17,17,34
230,CHENNAI,HYDERABAD,458,459,917
231,CHENNAI,INDORE,24,22,46
232,CHENNAI,JAIPUR,40,43,83
233,CHENNAI,JODHPUR,43,45,88
234,CHENNAI,KADAPA,3,5,8
235,CHENNAI,KANNUR,15,14,29
236,CHENNAI,KOCHI,234,243,477
237,CHENNAI,KOLKATA,264,270,534
238,CHENNAI,KOZHIKODE,26,28,54
239,CHENNAI,KURNOOL,3,3,6
240,CHENNAI,LUCKNOW,32,36,68
241,CHENNAI,MADURAI,138,136,274
242,CHENNAI,MANGALORE,21,18,39
243,CHENNAI,MUMBAI,925,872,1797
244,CHENNAI,MYSORE,18,19,37
245,CHENNAI,NAGPUR,29,22,51
246,CHENNAI,PATNA,51,58,109
247,CHENNAI,PORT BLAIR,140,148,288
248,CHENNAI,PUNE,211,193,404
249,CHENNAI,RAIPUR,24,22,46
250,CHENNAI,RAJAHMUNDRY,15,19,34
251,CHENNAI,RANCHI,37,42,79
252,CHENNAI,SHIRDI,65,61,126
253,CHENNAI,SRINAGAR,1,1,2
254,CHENNAI,SURAT,22,21,43
255,CHENNAI,TIRUCHIRAPALLY,65,59,124
256,CHENNAI,TRIVANDRUM,106,119,225
257,CHENNAI,TUTICORIN,56,53,109
258,CHENNAI,VADODARA,7,6,13
259,CHENNAI,VARANASI,42,44,86
260,CHENNAI,VIJAYAWADA,40,36,76
261,CHENNAI,VISAKHAPATNAM,106,114,220
262,COIMBATORE,DELHI,117,114,231
263,COIMBATORE,GUWAHATI,5,4,9
264,COIMBATORE,HYDERABAD,143,134,277
265,COIMBATORE,JAIPUR,5,4,9
266,COIMBATORE,MUMBAI,130,131,261
267,COIMBATORE,PUNE,39,35,74
268,COIMBATORE,SURAT,3,2,5
269,COIMBATORE,VISAKHAPATNAM,3,4,7
270,COIMBATORE,DURGAPUR,1,1,2
271,COIMBATORE,KOLKATA,5,5,10
272,COIMBATORE,RAIPUR,1,1,2
273,DABOLIM,DARBHANGA,27,1,28
274,DABOLIM,VIJAYAWADA,27,2,29
275,DABOLIM,DELHI,818,844,1662
276,DABOLIM,HYDERABAD,321,324,645
277,DABOLIM,INDORE,29,31,60
278,DABOLIM,JAIPUR,48,49,97
279,DABOLIM,KOLKATA,41,42,83
280,DABOLIM,LUCKNOW,77,91,168
281,DABOLIM,MUMBAI,1001,981,1982
282,DABOLIM,MYSORE,9,10,19
283,DABOLIM,NAGPUR,41,42,83
284,DABOLIM,PUNE,90,85,175
285,DABOLIM,RAIPUR,11,12,23
286,DABOLIM,RAJKOT,8,6,14
287,DABOLIM,SURAT,56,48,104
288,DARBHANGA,DELHI,74,72,146
289,DARBHANGA,HYDERABAD,40,36,76
290,DARBHANGA,KOLKATA,41,29,70
291,DARBHANGA,MUMBAI,51,47,98
292,DEHRA DUN,DELHI,211,204,415
293,DEHRA DUN,HYDERABAD,33,32,65
294,DEHRA DUN,JAIPUR,20,16,36
295,DEHRA DUN,LUCKNOW,47,43,90
296,DEHRA DUN,MUMBAI,126,120,246
297,DEHRA DUN,PUNE,9,26,35
298,DEHRA DUN,PATNA,27,3,30
299,DELHI,DHARAMSALA,59,48,107
300,DELHI,DIBRUGARH,111,86,197
301,DELHI,DIMAPUR,26,26,52
302,DELHI,DURGAPUR,50,58,108
303,DELHI,GAYA,41,42,83
304,DELHI,GORAKHPUR,116,120,236
305,DELHI,GUWAHATI,587,645,1232
306,DELHI,GWALIOR,26,31,57
307,DELHI,HYDERABAD,1004,938,1942
308,DELHI,IMPHAL,91,92,183
309,DELHI,INDORE,312,307,619
310,DELHI,JABALPUR,71,72,143
311,DELHI,JAGDALPUR,4,5,9
312,DELHI,JAIPUR,268,253,521
313,DELHI,JAMMU,291,298,589
314,DELHI,JHARSUGUDA,35,33,68
315,DELHI,JODHPUR,134,124,258
316,DELHI,JORHAT,10,9,19
317,DELHI,KANDLA,12,10,22
318,DELHI,KANNUR,12,11,23
319,DELHI,KANPUR,15,13,28
320,DELHI,KHAJURAHO,15,15,30
321,DELHI,KOCHI,358,347,705
322,DELHI,KOLKATA,1048,1007,2055
323,DELHI,KOZHIKODE,67,69,136
324,DELHI,KULLU,6,4,10
325,DELHI,LEH,154,197,351
326,DELHI,LUCKNOW,583,584,1167
327,DELHI,MADURAI,48,45,93
328,DELHI,MANGALORE,16,15,31
329,DELHI,MUMBAI,2357,2135,4492
330,DELHI,NAGPUR,200,185,385
331,DELHI,NASIK,18,16,34
332,DELHI,PANTNAGAR,19,20,39
333,DELHI,PATNA,574,650,1224
334,DELHI,PORT BLAIR,38,33,71
335,DELHI,PUNE,1062,953,2015
336,DELHI,RAIPUR,273,268,541
337,DELHI,RAJKOT,137,115,252
338,DELHI,RANCHI,314,360,674
339,DELHI,SHIRDI,90,81,171
340,DELHI,SILCHAR,16,13,29
341,DELHI,SRINAGAR,888,974,1862
342,DELHI,SURAT,176,147,323
343,DELHI,TIRUCHIRAPALLY,8,7,15
344,DELHI,TIRUPATI,23,23,46
345,DELHI,TRIVANDRUM,130,135,265
346,DELHI,UDAIPUR,285,273,558
347,DELHI,VADODARA,218,172,390
348,DELHI,VARANASI,363,364,727
349,DELHI,VIJAYAWADA,81,76,157
350,DELHI,VISAKHAPATNAM,164,156,320
351,DELHI,Kushinagar International Airport,3,3,6
352,DELHI,HUBLI,27,26,53
353,DELHI,JAISALMER,47,45,92
354,DELHI,SIMLA,10,7,17
355,Deoghar Airport,KOLKATA,10,8,18
356,Deoghar Airport,DELHI,35,33,68
357,DIBRUGARH,DIMAPUR,1,1,2
358,DIBRUGARH,GUWAHATI,50,28,78
359,DIBRUGARH,IMPHAL,12,12,24
360,DIBRUGARH,KOLKATA,60,61,121
361,DIBRUGARH,MUMBAI,1,1,2
362,DIBRUGARH,SHILLONG,2,3,5
363,DIBRUGARH,LILABARI,1,1,2
364,DIBRUGARH,PASIGHAT,1,1,2
365,DIBRUGARH,TEZU,1,1,2
366,DIMAPUR,GUWAHATI,19,16,35
367,DIMAPUR,IMPHAL,13,6,19
368,DIMAPUR,KOLKATA,53,54,107
369,DIMAPUR,MUMBAI,3,2,5
370,DIMAPUR,SHILLONG,4,3,7
371,DIMAPUR,LILABARI,27,1,28
372,DIU,MUMBAI,17,16,33
373,DURGAPUR,HYDERABAD,24,23,47
374,DURGAPUR,MUMBAI,34,32,66
375,DURGAPUR,VADODARA,27,1,28
376,GAYA,KOLKATA,30,21,51
377,GAYA,MUMBAI,2,3,5
378,GHAZIABAD,HUBLI,6,6,12
379,GHAZIABAD,KALABURAGI,4,4,8
380,GORAKHPUR,HYDERABAD,42,46,88
381,GORAKHPUR,KOLKATA,21,20,41
382,GORAKHPUR,LUCKNOW,10,8,18
383,GORAKHPUR,MUMBAI,89,90,179
384,GUWAHATI,HYDERABAD,47,45,92
385,GUWAHATI,IMPHAL,157,175,332
386,GUWAHATI,JAIPUR,49,51,100
387,GUWAHATI,JODHPUR,2,2,4
388,GUWAHATI,JORHAT,7,7,14
389,GUWAHATI,KOLKATA,335,334,669
390,GUWAHATI,LUCKNOW,35,34,69
391,GUWAHATI,MUMBAI,147,133,280
392,GUWAHATI,PASIGHAT,7,7,14
393,GUWAHATI,PATNA,24,27,51
394,GUWAHATI,PUNE,45,40,85
395,GUWAHATI,RUPSI,9,11,20
396,GUWAHATI,SHILLONG,3,2,5
397,GUWAHATI,SILCHAR,43,40,83
398,GUWAHATI,TEZPUR,1,1,2
399,GUWAHATI,TEZU,7,10,17
400,GUWAHATI,LILABARI,2,3,5
401,GUWAHATI,UDAIPUR,1,1,2
402,GWALIOR,INDORE,3,4,7
403,GWALIOR,MUMBAI,13,14,27
404,GWALIOR,JABALPUR,1,1,2
405,HUBLI,HYDERABAD,16,19,35
406,HUBLI,MANGALORE,9,5,14
407,HUBLI,MUMBAI,20,21,41
408,HUBLI,MYSORE,3,2,5
409,HYDERABAD,IMPHAL,4,3,7
410,HYDERABAD,INDORE,113,117,230
411,HYDERABAD,JABALPUR,20,20,40
412,HYDERABAD,JAGDALPUR,12,12,24
413,HYDERABAD,JAIPUR,158,159,317
414,HYDERABAD,JAMMU,4,5,9
415,HYDERABAD,JAMNAGAR,5,4,9
416,HYDERABAD,JODHPUR,40,41,81
417,HYDERABAD,KADAPA,11,12,23
418,HYDERABAD,KANNUR,17,17,34
419,HYDERABAD,KOCHI,191,200,391
420,HYDERABAD,KOLHAPUR,20,18,38
421,HYDERABAD,KOLKATA,346,349,695
422,HYDERABAD,KOZHIKODE,19,19,38
423,HYDERABAD,LUCKNOW,94,97,191
424,HYDERABAD,MADURAI,48,44,92
425,HYDERABAD,MANGALORE,41,40,81
426,HYDERABAD,MUMBAI,632,613,1245
427,HYDERABAD,MYSORE,29,26,55
428,HYDERABAD,NAGPUR,21,21,42
429,HYDERABAD,NASIK,8,8,16
430,HYDERABAD,PATNA,87,95,182
431,HYDERABAD,PONDICHERRY,15,14,29
432,HYDERABAD,PUNE,177,165,342
433,HYDERABAD,RAIPUR,100,108,208
434,HYDERABAD,RAJAHMUNDRY,105,100,205
435,HYDERABAD,RANCHI,42,44,86
436,HYDERABAD,SHIRDI,73,75,148
437,HYDERABAD,SURAT,41,37,78
438,HYDERABAD,TIRUCHIRAPALLY,28,34,62
439,HYDERABAD,TIRUPATI,215,214,429
440,HYDERABAD,TRIVANDRUM,44,44,88
441,HYDERABAD,UDAIPUR,48,46,94
442,HYDERABAD,VADODARA,46,46,92
443,HYDERABAD,VARANASI,102,104,206
444,HYDERABAD,VIJAYAWADA,99,100,199
445,HYDERABAD,VISAKHAPATNAM,219,206,425
446,HYDERABAD,KANPUR,2,2,4
447,HYDERABAD,PORT BLAIR,28,30,58
448,HYDERABAD,VIDYANAGAR,8,8,16
449,IMPHAL,KOLKATA,147,142,289
450,IMPHAL,MUMBAI,4,8,12
451,IMPHAL,SHILLONG,7,7,14
452,IMPHAL,SILCHAR,3,2,5
453,IMPHAL,TEZU,6,4,10
454,INDORE,JABALPUR,18,22,40
455,INDORE,JAIPUR,20,19,39
456,INDORE,JAMMU,16,17,33
457,INDORE,KOLKATA,46,46,92
458,INDORE,LUCKNOW,20,20,40
459,INDORE,MUMBAI,234,223,457
460,INDORE,NAGPUR,22,23,45
461,INDORE,PUNE,58,45,103
462,INDORE,RAIPUR,53,51,104
463,INDORE,JODHPUR,16,15,31
464,ITANAGAR,MUMBAI,1,1,2
465,ITANAGAR,KOLKATA,2,3,5
466,ITANAGAR,DIBRUGARH,1,1,2
467,ITANAGAR,PASIGHAT,1,1,2
468,ITANAGAR,ZIRO,1,1,2
469,JABALPUR,MUMBAI,57,47,104
470,JABALPUR,PUNE,19,19,38
471,JAGDALPUR,RAIPUR,12,11,23
472,JAIPUR,JAISALMER,10,10,20
473,JAIPUR,KOLKATA,109,111,220
474,JAIPUR,LUCKNOW,20,19,39
475,JAIPUR,MUMBAI,508,467,975
476,JAIPUR,PUNE,96,82,178
477,JAIPUR,SURAT,41,35,76
478,JAIPUR,UDAIPUR,22,20,42
479,JAISALMER,MUMBAI,34,27,61
480,JAMMU,LEH,21,84,105
481,JAMMU,MUMBAI,18,75,93
482,JAMMU,SRINAGAR,194,195,389
483,JAMNAGAR,MUMBAI,45,48,93
484,JEYPORE,VISAKHAPATNAM,2,2,4
485,JHARSUGUDA,KOLKATA,13,13,26
486,JHARSUGUDA,RAIPUR,27,1,28
487,JODHPUR,KOLKATA,10,9,19
488,JODHPUR,MUMBAI,128,117,245
489,JORHAT,KOLKATA,29,32,61
490,KADAPA,VIJAYAWADA,2,3,5
491,KADAPA,VISAKHAPATNAM,3,3,6
492,KALABURAGI,TIRUPATI,4,3,7
493,KANDLA,MUMBAI,24,24,48
494,KANNUR,KOCHI,12,12,24
495,KANNUR,KOZHIKODE,1,2,3
496,KANNUR,MUMBAI,47,44,91
497,KANNUR,TRIVANDRUM,10,12,22
498,KANNUR,VARANASI,1,26,27
499,KANPUR,MUMBAI,68,64,132
500,KESHOD,MUMBAI,7,7,14
501,KHAJURAHO,VARANASI,5,2,7
502,KOCHI,KOLKATA,48,50,98
503,KOCHI,MUMBAI,306,296,602
504,KOCHI,PUNE,44,46,90
505,KOCHI,TRIVANDRUM,18,17,35
506,KOCHI,LUCKNOW,2,2,4
507,KOCHI,NAGPUR,27,1,28
508,KOCHI,PATNA,6,4,10
509,KOCHI,RAIPUR,2,2,4
510,KOCHI,VARANASI,1,2,3
511,KOCHI,VISAKHAPATNAM,2,26,28
512,KOLHAPUR,TIRUPATI,15,19,34
513,KOLHAPUR,MUMBAI,4,4,8
514,KOLKATA,LILABARI,12,12,24
515,KOLKATA,LUCKNOW,99,115,214
516,KOLKATA,MANGALORE,3,4,7
517,KOLKATA,MUMBAI,593,577,1170
518,KOLKATA,NAGPUR,56,59,115
519,KOLKATA,PATNA,104,118,222
520,KOLKATA,PORT BLAIR,182,182,364
521,KOLKATA,PUNE,210,171,381
522,KOLKATA,RAIPUR,80,83,163
523,KOLKATA,RANCHI,43,45,88
524,KOLKATA,RUPSI,15,15,30
525,KOLKATA,SHILLONG,17,14,31
526,KOLKATA,SILCHAR,86,81,167
527,KOLKATA,SRINAGAR,8,17,25
528,KOLKATA,SURAT,44,37,81
529,KOLKATA,TRIVANDRUM,3,4,7
530,KOLKATA,UDAIPUR,5,4,9
531,KOLKATA,VARANASI,42,42,84
532,KOLKATA,VISAKHAPATNAM,21,22,43
533,KOZHIKODE,MUMBAI,71,65,136
534,KOZHIKODE,TRIVANDRUM,27,2,29
535,KURNOOL,VISAKHAPATNAM,5,5,10
536,LEH,SRINAGAR,12,10,22
537,LILABARI,PASIGHAT,1,1,2
538,LILABARI,SHILLONG,1,1,2
539,LILABARI,TEZPUR,1,1,2
540,LUCKNOW,MUMBAI,361,343,704
541,LUCKNOW,NAGPUR,21,19,40
542,LUCKNOW,PANTNAGAR,5,7,12
543,LUCKNOW,PATNA,35,38,73
544,LUCKNOW,PUNE,49,47,96
545,LUCKNOW,RAIPUR,21,18,39
546,LUCKNOW,RANCHI,35,42,77
547,MADURAI,MUMBAI,97,82,179
548,MADURAI,TIRUPATI,2,2,4
549,MADURAI,VIJAYAWADA,2,2,4
550,MANGALORE,MUMBAI,139,138,277
551,MANGALORE,PUNE,11,8,19
552,MANGALORE,RANCHI,2,1,3
553,MUMBAI,NAGPUR,282,312,594
554,MUMBAI,PATNA,192,219,411
555,MUMBAI,PORT BLAIR,31,29,60
556,MUMBAI,PUNE,2,26,28
557,MUMBAI,RAIPUR,157,174,331
558,MUMBAI,RAJKOT,128,126,254
559,MUMBAI,RANCHI,121,161,282
560,MUMBAI,SILCHAR,1,26,27
561,MUMBAI,SRINAGAR,51,114,165
562,MUMBAI,TIRUPATI,28,26,54
563,MUMBAI,TRIVANDRUM,111,133,244
564,MUMBAI,UDAIPUR,233,244,477
565,MUMBAI,VADODARA,95,102,197
566,MUMBAI,VARANASI,267,263,530
567,MUMBAI,VISAKHAPATNAM,60,71,131
568,MUMBAI,Sindhudurg Airport,13,14,27
569,NAGPUR,PUNE,176,154,330
570,PASIGHAT,TEZPUR,1,1,2
571,PATNA,PUNE,84,69,153
572,PATNA,RANCHI,38,36,74
573,PATNA,VARANASI,27,1,28
574,PATNA,SRINAGAR,27,1,28
575,PATNA,TRIVANDRUM,1,26,27
576,PORT BLAIR,VISAKHAPATNAM,7,9,16
577,PUNE,RAIPUR,15,18,33
578,PUNE,RANCHI,44,48,92
579,PUNE,TIRUPATI,7,8,15
580,PUNE,TRIVANDRUM,30,34,64
581,PUNE,VISAKHAPATNAM,5,6,11
582,RAIPUR,VISAKHAPATNAM,6,26,32
583,RAJAHMUNDRY,VISAKHAPATNAM,4,4,8
584,RANCHI,VISAKHAPATNAM,1,1,2
585,SHILLONG,SILCHAR,4,4,8
586,SHIRDI,TIRUPATI,4,5,9
587,SHIRDI,VISAKHAPATNAM,27,1,28
588,TIRUPATI,VIJAYAWADA,15,14,29
589,TIRUPATI,VISAKHAPATNAM,14,19,33
590,VARANASI,VISAKHAPATNAM,2,2,4
591,VIJAYAWADA,VISAKHAPATNAM,17,17,34
592,ZIRO,DIBRUGARH,1,1,2
593,ZIRO,LILABARI,1,1,2
