S.No.,CITY 1,CITY 2,AVG FLIGHTS TO CITY 2,AVG FLIGHTS FROM CITY 2,TOTAL AVG FLIGHTS
1,AGRA,AHMEDABAD,7,7,14
2,AGRA,BENGALURU,25,27,52
3,AGRA,BHOPAL,2,3,5
4,AGRA,LUCKNOW,6,6,12
5,AGRA,MUMBAI,14,16,30
6,AGATTI ISLAND,BENGALURU,1,1,2
7,AGATTI ISLAND,KOCHI,17,19,36
8,AGATTI ISLAND,MYSORE,1,1,2
9,AIZAWL,DELHI,20,20,40
10,AIZAWL,GUWAHATI,45,36,81
11,AIZAWL,IMPHAL,1,1,2
12,AIZAWL,KOLKATA,53,52,105
13,AIZAWL,MUMBAI,3,3,6
14,AIZAWL,SHILLONG,5,5,10
15,AHMEDABAD,AMRITSAR,12,11,23
16,AHMEDABAD,BAGDOGRA,49,36,85
17,AHMEDABAD,BELGAUM,8,8,16
18,AHMEDABAD,BENGALURU,426,406,832
19,AHMEDABAD,BHOPAL,19,17,36
20,AHMEDABAD,BHUBANESWAR,36,32,68
21,AHMEDABAD,BHUJ,5,5,10
22,AHMEDABAD,CHANDIGARH,118,86,204
23,AHMEDABAD,CHENNAI,108,95,203
24,AHMEDABAD,COIMBATORE,11,6,17
25,AHMEDABAD,DABOLIM,177,159,336
26,AHMEDABAD,DEHRA DUN,59,53,112
27,AHMEDABAD,DELHI,889,779,1668
28,AHMEDABAD,DURGAPUR,3,3,6
29,AHMEDABAD,GUWAHATI,6,7,13
30,AHMEDABAD,HYDERABAD,153,131,284
31,AHMEDABAD,INDORE,20,20,40
32,AHMEDABAD,JAIPUR,88,67,155
33,AHMEDABAD,JODHPUR,19,14,33
34,AHMEDABAD,KOCHI,36,31,67
35,AHMEDABAD,KOLHAPUR,7,5,12
36,AHMEDABAD,KOLKATA,190,146,336
37,AHMEDABAD,JAISALMER,1,1,2
38,AHMEDABAD,JAMMU,2,2,4
39,AHMEDABAD,LUCKNOW,89,65,154
40,AHMEDABAD,MUMBAI,768,762,1530
41,AHMEDABAD,NAGPUR,39,35,74
42,AHMEDABAD,NASIK,9,9,18
43,AHMEDABAD,PATNA,90,59,149
44,AHMEDABAD,PUNE,171,171,342
45,AHMEDABAD,RAIPUR,19,17,36
46,AHMEDABAD,RANCHI,22,20,42
47,AHMEDABAD,PORT BLAIR,2,1,3
48,AHMEDABAD,TRIVANDRUM,4,4,8
49,AHMEDABAD,VARANASI,54,34,88
50,AHMEDABAD,VISAKHAPATNAM,6,3,9
51,AMRITSAR,BENGALURU,32,39,71
52,AMRITSAR,CHENNAI,2,3,5
54,AMRITSAR,DABOLIM,14,18,32
55,AMRITSAR,DELHI,299,326,625
57,AMRITSAR,GUWAHATI,3,4,7
58,AMRITSAR,HYDERABAD,1,1,2
60,AMRITSAR,KOLKATA,50,45,95
61,AMRITSAR,LUCKNOW,14,14,28
62,AMRITSAR,MUMBAI,115,137,252
63,AMRITSAR,PATNA,15,13,28
64,AMRITSAR,PUNE,25,27,52
65,AMRITSAR,SRINAGAR,36,38,74
66,BHUBANESWAR,CHANDIGARH,5,6,11
67,BHUBANESWAR,CHENNAI,74,71,145
69,BHUBANESWAR,DELHI,375,416,791
70,BHUBANESWAR,HYDERABAD,129,138,267
71,BHUBANESWAR,JAIPUR,19,20,39
72,BHUBANESWAR,JHARSUGUDA,12,13,25
73,BHUBANESWAR,KOLKATA,173,190,363
74,BHUBANESWAR,LUCKNOW,5,4,9
75,BHUBANESWAR,MUMBAI,190,223,413
76,BHUBANESWAR,PATNA,35,27,62
77,BHUBANESWAR,PUNE,48,53,101
78,BHUBANESWAR,RAIPUR,17,17,34
80,BHUBANESWAR,RANCHI,5,5,10
81,BHUBANESWAR,VARANASI,19,19,38
82,BAREILLY,BENGALURU,20,24,44
83,BAREILLY,DELHI,10,11,21
84,BAREILLY,MUMBAI,27,33,60
85,BHUJ,MUMBAI,9,10,19
86,BHOPAL,CHENNAI,2,2,4
87,BHOPAL,DELHI,184,192,376
88,BHOPAL,HYDERABAD,19,19,38
89,BHOPAL,KOCHI,7,7,14
90,BHOPAL,MUMBAI,108,121,229
91,BHOPAL,RAIPUR,18,19,37
92,BHAVNAGAR,MUMBAI,11,12,23
93,BHAVNAGAR,PUNE,13,14,27
94,BIKANER,DELHI,11,11,22
95,BENGALURU,BHOPAL,42,39,81
96,BENGALURU,BHUBANESWAR,260,232,492
97,BENGALURU,"BIDAR AIRPORT, KARNATAKA",4,5,9
99,BENGALURU,CHANDIGARH,143,120,263
100,BENGALURU,CHENNAI,435,430,865
101,BENGALURU,COIMBATORE,82,89,171
102,BENGALURU,DABOLIM,464,452,916
103,BENGALURU,DARBHANGA,75,53,128
104,BENGALURU,DEHRA DUN,92,88,180
105,BENGALURU,DELHI,1738,1598,3336
106,BENGALURU,DIMAPUR,9,5,14
107,BENGALURU,DURGAPUR,44,43,87
108,BENGALURU,GORAKHPUR,10,9,19
109,BENGALURU,GUWAHATI,248,226,474
110,BENGALURU,GWALIOR,23,19,42
111,BENGALURU,HUBLI,40,40,80
112,BENGALURU,HYDERABAD,638,604,1242
113,BENGALURU,IMPHAL,7,4,11
114,BENGALURU,INDORE,113,107,220
115,BENGALURU,JABALPUR,21,17,38
116,BENGALURU,JAIPUR,202,172,374
117,BENGALURU,JAMMU,8,7,15
118,BENGALURU,JAMNAGAR,5,4,9
119,BENGALURU,JODHPUR,46,45,91
120,BENGALURU,JORHAT,7,6,13
121,BENGALURU,KADAPA,3,3,6
122,BENGALURU,"KALABURAGI, KARNATAKA",24,24,48
123,BENGALURU,KANNUR,36,36,72
124,BENGALURU,KANPUR,32,31,63
125,BENGALURU,KOCHI,640,641,1281
126,BENGALURU,KOLKATA,851,743,1594
127,BENGALURU,KOZHIKODE,40,43,83
128,BENGALURU,KURNOOL,4,5,9
129,BENGALURU,LUCKNOW,234,187,421
130,BENGALURU,MADURAI,59,54,113
131,BENGALURU,MANGALORE,193,198,391
132,BENGALURU,MUMBAI,1427,1491,2918
133,BENGALURU,MYSORE,6,9,15
134,BENGALURU,NAGPUR,140,128,268
135,BENGALURU,PATNA,250,161,411
136,BENGALURU,PONDICHERRY,10,9,19
137,BENGALURU,PORT BLAIR,70,67,137
138,BENGALURU,PUNE,519,577,1096
139,BENGALURU,RAIPUR,100,83,183
140,BENGALURU,RAJAHMUNDRY,38,38,76
141,BENGALURU,RAJKOT,43,46,89
142,BENGALURU,RANCHI,225,170,395
143,BENGALURU,SHIRDI,79,78,157
144,BENGALURU,SRINAGAR,9,15,24
145,BENGALURU,SURAT,45,45,90
146,BENGALURU,TIRUCHIRAPALLY,37,34,71
147,BENGALURU,TIRUPATI,20,18,38
148,BENGALURU,TRIVANDRUM,135,147,282
149,BENGALURU,TUTICORIN,15,15,30
150,BENGALURU,UDAIPUR,43,43,86
151,BENGALURU,VADODARA,58,58,116
152,BENGALURU,VARANASI,154,124,278
153,BENGALURU,VIJAYAWADA,91,91,182
154,BENGALURU,VISAKHAPATNAM,187,184,371
155,BENGALURU,NASIK,2,1,3
156,MUMBAI,NAGPUR,275,249,524
157,MUMBAI,PATNA,230,160,390
158,MUMBAI,PORT BLAIR,4,4,8
159,MUMBAI,RAIPUR,160,134,294
160,MUMBAI,RAJKOT,127,128,255
161,MUMBAI,RANCHI,153,121,274
162,MUMBAI,SILCHAR,1,1,2
164,MUMBAI,SRINAGAR,100,134,234
165,MUMBAI,TIRUPATI,11,8,19
166,MUMBAI,TRIVANDRUM,125,125,250
167,MUMBAI,UDAIPUR,193,174,367
168,MUMBAI,VADODARA,125,139,264
169,MUMBAI,VARANASI,279,200,479
170,MUMBAI,VISAKHAPATNAM,43,46,89
171,MUMBAI,Sindhudurg Airport,14,14,28
172,BENGALURU,VIDYANAGAR,1,1,2
173,KOZHIKODE,MUMBAI,61,58,119
174,KOLKATA,LILABARI,13,13,26
175,KOLKATA,LUCKNOW,127,131,258
176,KOLKATA,MANGALORE,3,2,5
177,BHOPAL,BILASPUR,1,1,2
178,KOLKATA,MUMBAI,562,653,1215
179,KOLKATA,NAGPUR,42,48,90
182,KOLKATA,PATNA,143,112,255
183,KOLKATA,PORT BLAIR,181,197,378
184,KOLKATA,PUNE,152,190,342
185,KOLKATA,RAIPUR,97,104,201
186,KOLKATA,RANCHI,52,51,103
187,KOLKATA,RUPSI,13,14,27
188,KOLKATA,SHILLONG,16,16,32
189,KOLKATA,SILCHAR,88,89,177
190,KOLKATA,SRINAGAR,10,17,27
191,KOLKATA,SURAT,51,77,128
193,KOLKATA,TRIVANDRUM,6,8,14
194,BHUBANESWAR,JEYPORE,1,1,2
195,KOLKATA,UDAIPUR,4,4,8
196,KOLKATA,VARANASI,60,58,118
197,KOLKATA,VISAKHAPATNAM,37,44,81
198,KADAPA,VIJAYAWADA,5,4,9
199,KADAPA,VISAKHAPATNAM,4,5,9
200,COIMBATORE,DELHI,125,116,241
201,COIMBATORE,GUWAHATI,5,3,8
202,COIMBATORE,HYDERABAD,178,167,345
203,COIMBATORE,JAIPUR,6,4,10
204,COIMBATORE,MUMBAI,125,138,263
205,BILASPUR,INDORE,5,4,9
206,COIMBATORE,PUNE,41,45,86
207,COIMBATORE,SURAT,5,5,10
208,COIMBATORE,TIRUPATI,6,7,13
209,COIMBATORE,VISAKHAPATNAM,1,4,5
210,KANNUR,KOCHI,15,13,28
211,KANNUR,KOZHIKODE,1,1,2
212,KANNUR,MUMBAI,20,17,37
213,KANNUR,TRIVANDRUM,14,14,28
214,KOCHI,KOLKATA,32,32,64
215,KOCHI,MUMBAI,226,247,473
216,KOCHI,MYSORE,12,11,23
217,KOCHI,PUNE,39,44,83
218,KOCHI,RANCHI,4,3,7
219,KOCHI,TRIVANDRUM,19,20,39
220,DARBHANGA,DELHI,62,71,133
221,DARBHANGA,HYDERABAD,36,41,77
222,DARBHANGA,KOLKATA,29,36,65
223,DARBHANGA,MUMBAI,49,78,127
224,DEHRA DUN,DELHI,246,248,494
225,DEHRA DUN,GUWAHATI,4,3,7
226,DEHRA DUN,HYDERABAD,43,41,84
227,DEHRA DUN,JAIPUR,24,23,47
228,DEHRA DUN,KOLKATA,22,22,44
229,DEHRA DUN,LUCKNOW,44,46,90
230,DEHRA DUN,MUMBAI,154,171,325
231,DEHRA DUN,PANTNAGAR,3,3,6
232,DEHRA DUN,PUNE,8,10,18
233,DEHRA DUN,VARANASI,13,12,25
234,DELHI,DHARAMSALA,54,50,104
235,DELHI,DIBRUGARH,113,85,198
236,DELHI,DIMAPUR,26,27,53
237,DELHI,DURGAPUR,56,52,108
238,DELHI,GAYA,47,38,85
239,DELHI,GORAKHPUR,114,94,208
241,DELHI,GUWAHATI,610,635,1245
242,DELHI,GWALIOR,33,32,65
243,DELHI,HYDERABAD,957,981,1938
244,DELHI,IMPHAL,82,75,157
245,DELHI,INDORE,293,289,582
246,DELHI,JABALPUR,44,41,85
247,DELHI,JAGDALPUR,3,5,8
248,DELHI,JAIPUR,247,219,466
249,DELHI,JAMMU,317,310,627
250,DELHI,JHARSUGUDA,21,21,42
251,CHENNAI,NASIK,2,2,4
252,DELHI,JODHPUR,112,114,226
253,DELHI,JORHAT,7,8,15
254,DELHI,KANDLA,13,13,26
255,DELHI,KANNUR,13,14,27
256,DELHI,KANPUR,16,14,30
257,DELHI,KHAJURAHO,11,11,22
258,DELHI,KOCHI,332,372,704
259,DELHI,KOLKATA,1216,1113,2329
260,DELHI,KOZHIKODE,86,89,175
261,DELHI,KULLU,7,4,11
262,DELHI,LEH,262,363,625
263,DELHI,LUCKNOW,600,510,1110
264,DELHI,MADURAI,35,36,71
265,DELHI,MANGALORE,31,32,63
266,DELHI,MUMBAI,1898,2212,4110
267,DELHI,NAGPUR,136,142,278
268,DELHI,NASIK,37,42,79
269,DELHI,PANTNAGAR,18,17,35
270,DELHI,PATNA,597,440,1037
271,COIMBATORE,KOLKATA,1,1,2
272,DELHI,PORT BLAIR,40,38,78
273,DELHI,PUNE,836,992,1828
274,DELHI,RAIPUR,283,274,557
275,DELHI,RAJKOT,114,126,240
276,DELHI,RANCHI,386,332,718
277,DELHI,SHIRDI,84,90,174
278,DELHI,SILCHAR,19,22,41
279,DELHI,SRINAGAR,1030,1100,2130
280,DELHI,SURAT,139,170,309
281,DELHI,TIRUCHIRAPALLY,11,9,20
282,DELHI,TIRUPATI,23,20,43
283,DELHI,TRIVANDRUM,94,102,196
284,DELHI,UDAIPUR,180,191,371
285,DELHI,VADODARA,151,184,335
286,DELHI,VARANASI,289,256,545
287,DELHI,VIJAYAWADA,81,82,163
288,DELHI,VISAKHAPATNAM,182,182,364
289,DELHI,Kushinagar International Airport,7,5,12
291,DIBRUGARH,DIMAPUR,1,1,2
292,DIBRUGARH,GUWAHATI,30,4,34
293,DIBRUGARH,IMPHAL,13,14,27
294,DIBRUGARH,KOLKATA,89,82,171
295,DIBRUGARH,MUMBAI,4,6,10
296,DIBRUGARH,SHILLONG,2,3,5
297,DIU,MUMBAI,14,14,28
298,DIMAPUR,GUWAHATI,14,12,26
299,DIMAPUR,IMPHAL,12,12,24
300,DIMAPUR,KOLKATA,57,51,108
301,DIMAPUR,MUMBAI,2,2,4
302,DIMAPUR,SHILLONG,4,4,8
303,GUWAHATI,HYDERABAD,56,57,113
304,GUWAHATI,IMPHAL,179,182,361
306,GUWAHATI,JAIPUR,43,47,90
307,GUWAHATI,JODHPUR,2,1,3
308,GUWAHATI,JORHAT,11,10,21
309,GUWAHATI,KOLKATA,395,416,811
310,GUWAHATI,LUCKNOW,34,37,71
311,GUWAHATI,MUMBAI,147,171,318
312,GUWAHATI,PASIGHAT,5,5,10
313,GUWAHATI,PATNA,44,37,81
314,GUWAHATI,PUNE,38,45,83
315,GUWAHATI,RUPSI,8,8,16
316,GUWAHATI,SHILLONG,1,1,2
317,GUWAHATI,SILCHAR,31,34,65
318,GUWAHATI,TEZPUR,1,1,2
319,GUWAHATI,TEZU,13,12,25
320,GUWAHATI,VARANASI,5,5,10
321,GAYA,KOLKATA,11,12,23
322,DELHI,JAISALMER,3,2,5
323,"KALABURAGI, KARNATAKA",TIRUPATI,2,2,4
324,DABOLIM,DELHI,750,707,1457
326,DABOLIM,HYDERABAD,370,357,727
327,DABOLIM,INDORE,32,30,62
328,DABOLIM,JAIPUR,50,46,96
329,DABOLIM,KOLKATA,90,69,159
330,DABOLIM,LUCKNOW,70,58,128
331,DABOLIM,MUMBAI,752,752,1504
332,DABOLIM,MYSORE,10,12,22
333,DABOLIM,NAGPUR,42,39,81
334,DABOLIM,PUNE,100,100,200
335,DABOLIM,RAIPUR,9,9,18
336,DABOLIM,RAJKOT,13,13,26
337,DABOLIM,SURAT,49,56,105
338,GORAKHPUR,HYDERABAD,36,42,78
339,DELHI,PAKYONG,13,12,25
340,GORAKHPUR,KOLKATA,19,20,39
341,GORAKHPUR,LUCKNOW,7,10,17
342,GORAKHPUR,MUMBAI,76,94,170
343,GWALIOR,INDORE,3,3,6
344,GWALIOR,MUMBAI,6,8,14
345,HUBLI,HYDERABAD,19,18,37
346,HUBLI,MANGALORE,6,7,13
347,DELHI,SIMLA,8,6,14
348,HUBLI,MUMBAI,18,19,37
349,HUBLI,MYSORE,4,3,7
350,HYDERABAD,IMPHAL,4,4,8
351,HYDERABAD,INDORE,122,121,243
352,HYDERABAD,JABALPUR,21,21,42
353,HYDERABAD,JAGDALPUR,13,13,26
354,HYDERABAD,JAIPUR,186,166,352
355,HYDERABAD,JAMMU,5,1,6
356,HYDERABAD,JAMNAGAR,5,5,10
357,HYDERABAD,JODHPUR,22,22,44
358,HYDERABAD,KADAPA,14,15,29
359,HYDERABAD,KANNUR,18,20,38
360,HYDERABAD,KOCHI,189,194,383
361,HYDERABAD,KOLHAPUR,24,22,46
362,HYDERABAD,KOLKATA,411,359,770
363,HYDERABAD,KOZHIKODE,19,19,38
364,HYDERABAD,LUCKNOW,105,98,203
366,HYDERABAD,MADURAI,49,46,95
367,HYDERABAD,MANGALORE,40,41,81
368,HYDERABAD,MUMBAI,608,666,1274
369,HYDERABAD,MYSORE,29,26,55
370,HYDERABAD,NAGPUR,23,23,46
371,HYDERABAD,NASIK,18,20,38
372,HYDERABAD,PATNA,129,74,203
373,HYDERABAD,PONDICHERRY,20,19,39
374,HYDERABAD,PUNE,170,204,374
376,HYDERABAD,RAIPUR,91,84,175
377,HYDERABAD,RAJAHMUNDRY,98,94,192
378,HYDERABAD,RANCHI,62,56,118
379,HYDERABAD,SHIRDI,63,73,136
381,HYDERABAD,SRINAGAR,40,35,75
382,HYDERABAD,SURAT,43,49,92
383,HYDERABAD,TIRUCHIRAPALLY,33,36,69
384,HYDERABAD,TIRUPATI,188,191,379
385,HYDERABAD,TRIVANDRUM,57,58,115
386,HYDERABAD,UDAIPUR,26,25,51
387,HYDERABAD,VADODARA,54,58,112
388,HYDERABAD,VARANASI,101,96,197
389,HYDERABAD,VIJAYAWADA,104,94,198
390,HYDERABAD,VISAKHAPATNAM,251,247,498
391,INDORE,JABALPUR,18,17,35
392,INDORE,JAIPUR,20,20,40
393,INDORE,JAMMU,17,19,36
394,INDORE,KOLKATA,42,36,78
395,GUWAHATI,LILABARI,1,1,2
396,INDORE,LUCKNOW,20,19,39
397,INDORE,MUMBAI,183,209,392
398,INDORE,NAGPUR,20,20,40
399,INDORE,PUNE,40,40,80
400,INDORE,RAIPUR,45,43,88
401,IMPHAL,KOLKATA,138,139,277
402,IMPHAL,MUMBAI,5,5,10
403,IMPHAL,SHILLONG,7,7,14
404,NASIK,PUNE,8,9,17
405,AGARTALA,AHMEDABAD,6,4,10
406,AGARTALA,AIZAWL,6,6,12
407,AGARTALA,BENGALURU,49,43,92
408,AGARTALA,CHENNAI,19,9,28
409,GWALIOR,JABALPUR,1,1,2
410,AGARTALA,DELHI,50,46,96
411,AGARTALA,DIBRUGARH,14,14,28
412,AGARTALA,GUWAHATI,68,66,134
413,AGARTALA,IMPHAL,17,17,34
414,AGARTALA,KOLKATA,359,301,660
415,AGARTALA,SHILLONG,7,6,13
416,BAGDOGRA,BENGALURU,141,150,291
417,BAGDOGRA,CHENNAI,46,47,93
418,BAGDOGRA,DELHI,403,463,866
419,BAGDOGRA,DIBRUGARH,29,28,57
420,BAGDOGRA,HYDERABAD,48,48,96
421,BAGDOGRA,KOLKATA,297,281,578
422,BAGDOGRA,MUMBAI,90,98,188
423,CHANDIGARH,CHENNAI,48,55,103
424,CHANDIGARH,DABOLIM,64,68,132
425,CHANDIGARH,DEHRA DUN,1,1,2
426,CHANDIGARH,DELHI,277,293,570
427,CHANDIGARH,DHARAMSALA,11,13,24
428,HYDERABAD,KANPUR,1,1,2
429,CHANDIGARH,GUWAHATI,9,8,17
430,CHANDIGARH,HYDERABAD,93,108,201
431,CHANDIGARH,JAIPUR,36,33,69
432,CHANDIGARH,KOLKATA,33,37,70
433,CHANDIGARH,KULLU,3,2,5
434,CHANDIGARH,LEH,6,11,17
435,CHANDIGARH,LUCKNOW,33,36,69
436,CHANDIGARH,MUMBAI,258,323,581
437,CHANDIGARH,PATNA,36,32,68
438,CHANDIGARH,PUNE,53,53,106
439,CHANDIGARH,SRINAGAR,102,104,206
441,ALLAHABAD,BENGALURU,39,41,80
442,HYDERABAD,PORT BLAIR,3,4,7
443,ALLAHABAD,BHOPAL,6,9,15
444,ALLAHABAD,BHUBANESWAR,18,19,37
445,ALLAHABAD,BILASPUR,5,5,10
446,ALLAHABAD,DEHRA DUN,14,18,32
447,ALLAHABAD,DELHI,48,58,106
448,ALLAHABAD,GORAKHPUR,14,6,20
449,ALLAHABAD,INDORE,15,18,33
450,ALLAHABAD,LUCKNOW,10,10,20
451,ALLAHABAD,MUMBAI,28,35,63
452,ALLAHABAD,PUNE,15,18,33
453,ALLAHABAD,RAIPUR,16,16,32
454,MANGALORE,MUMBAI,206,225,431
455,MANGALORE,PUNE,9,13,22
456,HYDERABAD,VIDYANAGAR,1,1,2
457,BELGAUM,BENGALURU,20,20,40
458,BELGAUM,DELHI,24,23,47
459,BELGAUM,HYDERABAD,35,32,67
460,BELGAUM,INDORE,3,3,6
461,BELGAUM,JODHPUR,4,4,8
462,IMPHAL,TEZU,10,10,20
463,BELGAUM,MUMBAI,26,27,53
464,BELGAUM,NAGPUR,3,3,6
465,BELGAUM,NASIK,4,4,8
466,INDORE,JODHPUR,15,18,33
467,BELGAUM,PUNE,6,7,13
468,BELGAUM,SURAT,3,3,6
469,BELGAUM,TIRUPATI,3,3,6
470,JAMMU,LEH,17,23,40
471,JAMMU,MUMBAI,12,62,74
472,JAMMU,SRINAGAR,159,162,321
474,LEH,SRINAGAR,55,9,64
475,MADURAI,MUMBAI,56,65,121
476,MADURAI,TIRUPATI,11,11,22
477,JAIPUR,JAISALMER,1,1,2
478,MADURAI,VIJAYAWADA,2,2,4
479,PASIGHAT,TEZPUR,1,1,2
480,AURANGABAD,DELHI,74,60,134
481,AURANGABAD,HYDERABAD,23,20,43
482,AURANGABAD,MUMBAI,74,73,147
483,KANDLA,MUMBAI,21,21,42
484,PORT BLAIR,VISAKHAPATNAM,12,12,24
485,JAIPUR,KOLKATA,140,139,279
486,JAIPUR,LUCKNOW,20,19,39
487,JAISALMER,MUMBAI,4,3,7
488,JAIPUR,MUMBAI,327,409,736
489,JAIPUR,PUNE,100,106,206
490,JAIPUR,SURAT,30,37,67
491,JAIPUR,UDAIPUR,27,21,48
492,JAIPUR,VADODARA,2,2,4
493,JAIPUR,VARANASI,6,5,11
494,JODHPUR,KOLKATA,18,17,35
495,JODHPUR,MUMBAI,79,85,164
496,JAMNAGAR,MUMBAI,42,46,88
497,JAGDALPUR,RAIPUR,12,11,23
498,JABALPUR,MUMBAI,29,29,58
499,JABALPUR,PUNE,16,19,35
500,JHARSUGUDA,KOLKATA,12,12,24
501,JHARSUGUDA,RAIPUR,9,7,16
502,JORHAT,KOLKATA,36,36,72
503,KURNOOL,VISAKHAPATNAM,6,6,12
504,KESHOD,MUMBAI,7,7,14
505,KOLHAPUR,TIRUPATI,13,16,29
506,KOCHI,LUCKNOW,1,1,2
507,KANPUR,MUMBAI,43,62,105
508,KOCHI,NAGPUR,1,1,2
509,KOCHI,PATNA,1,1,2
511,AJMER,INDORE,2,3,5
513,KOLHAPUR,MUMBAI,4,3,7
514,AJMER,SURAT,3,4,7
515,LUCKNOW,MUMBAI,223,328,551
516,LUCKNOW,NAGPUR,19,21,40
517,LUCKNOW,PANTNAGAR,8,7,15
518,LUCKNOW,PATNA,38,31,69
519,LUCKNOW,PUNE,47,50,97
520,KOLKATA,PAKYONG,6,5,11
521,LUCKNOW,RAIPUR,16,16,32
522,LUCKNOW,RANCHI,35,33,68
523,LUCKNOW,SRINAGAR,8,11,19
525,CHENNAI,COIMBATORE,301,298,599
526,CHENNAI,DABOLIM,47,48,95
527,CHENNAI,DARBHANGA,7,2,9
528,CHENNAI,DEHRA DUN,7,12,19
529,CHENNAI,DELHI,693,665,1358
530,CHENNAI,DIBRUGARH,1,1,2
531,CHENNAI,DURGAPUR,44,43,87
532,CHENNAI,GUWAHATI,97,94,191
533,CHENNAI,HUBLI,17,19,36
534,CHENNAI,HYDERABAD,408,415,823
535,CHENNAI,INDORE,17,16,33
536,CHENNAI,JAIPUR,42,43,85
537,CHENNAI,JODHPUR,48,48,96
538,CHENNAI,KADAPA,3,5,8
540,CHENNAI,KANNUR,15,16,31
541,CHENNAI,KOCHI,187,196,383
542,CHENNAI,KOLKATA,322,295,617
543,CHENNAI,KOZHIKODE,20,20,40
544,CHENNAI,KURNOOL,5,4,9
545,CHENNAI,LUCKNOW,58,42,100
546,CHENNAI,MADURAI,129,125,254
547,CHENNAI,MANGALORE,19,21,40
548,CHENNAI,MUMBAI,828,892,1720
549,CHENNAI,MYSORE,20,20,40
550,CHENNAI,NAGPUR,3,4,7
551,CHENNAI,PATNA,32,31,63
552,CHENNAI,PORT BLAIR,212,215,427
553,CHENNAI,PUNE,163,183,346
555,CHENNAI,RAIPUR,29,27,56
556,CHENNAI,RAJAHMUNDRY,22,24,46
557,CHENNAI,RANCHI,44,45,89
558,CHENNAI,SHIRDI,53,53,106
559,CHENNAI,SRINAGAR,4,5,9
560,CHENNAI,SURAT,36,41,77
561,CHENNAI,TIRUCHIRAPALLY,70,64,134
562,CHENNAI,TRIVANDRUM,112,131,243
563,CHENNAI,TUTICORIN,60,56,116
564,CHENNAI,VARANASI,29,28,57
565,CHENNAI,VIJAYAWADA,33,39,72
566,CHENNAI,VISAKHAPATNAM,86,93,179
567,NAGPUR,PUNE,145,164,309
568,BILASPUR,DELHI,5,5,10
569,BILASPUR,JABALPUR,3,4,7
570,PATNA,PUNE,51,46,97
571,PATNA,RANCHI,31,37,68
573,PUNE,RAIPUR,20,19,39
574,NASIK,TIRUPATI,2,2,4
575,PUNE,RANCHI,47,43,90
576,PUNE,TIRUPATI,6,5,11
579,DURGAPUR,HYDERABAD,31,33,64
580,DURGAPUR,MUMBAI,33,36,69
582,DURGAPUR,TRIVANDRUM,1,2,3
583,PUNE,TRIVANDRUM,31,31,62
584,PUNE,VISAKHAPATNAM,11,7,18
585,RAJAHMUNDRY,TIRUPATI,4,4,8
586,RAJAHMUNDRY,VISAKHAPATNAM,5,4,9
587,RAIPUR,SRINAGAR,6,5,11
590,SHIRDI,TIRUPATI,5,4,9
591,SHILLONG,SILCHAR,3,4,7
592,TIRUPATI,VIJAYAWADA,9,7,16
593,TIRUPATI,VISAKHAPATNAM,14,18,32
594,VARANASI,VISAKHAPATNAM,1,1,2
595,GHAZIABAD,HUBLI,6,7,13
596,GHAZIABAD,"KALABURAGI, KARNATAKA",2,2,4
597,VIJAYAWADA,VISAKHAPATNAM,19,19,38
598,Deoghar Airport,KOLKATA,6,8,14
599,Deoghar Airport,DELHI,33,44,77
600,Zero Airport,DIBRUGARH,1,1,2
