S.No.,CITY 1,CITY 2,AVG FLIGHTS TO CITY 2,AVG FLIGHTS FROM CITY 2,TOTAL AVG FLIGHTS
1,AGRA,AHMEDABAD,6,5,11
2,AGRA,BENGALURU,22,22,44
3,AGRA,BHOPAL,1,2,3
4,AGRA,LUCKNOW,3,4,7
5,AGRA,MUMBAI,15,16,31
6,AGATTI ISLAND,BENGALURU,1,1,2
7,AGATTI ISLAND,KOCHI,12,15,27
8,AGATTI ISLAND,MYSORE,1,1,2
9,AIZAWL,DELHI,18,18,36
10,AIZAWL,GUWAHATI,40,35,75
11,AIZAWL,KOLKATA,54,50,104
12,AIZAWL,MUMBAI,2,2,4
13,AIZAWL,SHILLONG,5,4,9
14,AHMEDABAD,AMRITSAR,5,4,9
15,AHMEDABAD,BAGDOGRA,6,3,9
16,AHMEDABAD,BELGAUM,7,8,15
17,AHMEDABAD,BENGALURU,340,366,706
18,AHMEDABAD,BHOPAL,16,18,34
19,AHMEDABAD,BHUBANESWAR,13,14,27
20,AHMEDABAD,BHUJ,5,6,11
21,AHMEDABAD,CHANDIGARH,66,59,125
22,AHMEDABAD,CHENNAI,88,98,186
23,AHMEDABAD,COIMBATORE,8,6,14
24,AHMEDABAD,DABOLIM,145,164,309
25,AHMEDABAD,DEHRA DUN,59,56,115
26,AHMEDABAD,DELHI,729,758,1487
27,AHMEDABAD,DURGAPUR,3,2,5
28,AHMEDABAD,GUWAHATI,7,6,13
29,AHMEDABAD,HYDERABAD,121,130,251
30,AHMEDABAD,INDORE,17,18,35
31,AHMEDABAD,JAIPUR,66,59,125
32,AHMEDABAD,JODHPUR,18,16,34
33,AHMEDABAD,KOCHI,28,30,58
34,AHMEDABAD,KOLHAPUR,6,5,11
35,AHMEDABAD,KOLKATA,142,134,276
36,AHMEDABAD,LUCKNOW,61,56,117
37,AHMEDABAD,MUMBAI,781,790,1571
38,AHMEDABAD,NAGPUR,30,31,61
39,AHMEDABAD,NASIK,10,9,19
40,AHMEDABAD,PATNA,49,47,96
41,AHMEDABAD,PUNE,136,145,281
42,AHMEDABAD,RAIPUR,29,28,57
43,AHMEDABAD,RANCHI,14,14,28
44,AHMEDABAD,TRIVANDRUM,3,2,5
45,AHMEDABAD,VARANASI,43,42,85
46,AHMEDABAD,VISAKHAPATNAM,4,1,5
47,AMRITSAR,BENGALURU,26,27,53
48,AMRITSAR,CHENNAI,2,3,5
49,AHMEDABAD,UDAIPUR,22,1,23
50,AMRITSAR,DELHI,281,313,594
51,AMRITSAR,GUWAHATI,1,2,3
52,AMRITSAR,JAIPUR,5,5,10
53,AMRITSAR,JAMMU,22,3,25
54,AMRITSAR,KOLKATA,40,39,79
55,AMRITSAR,LUCKNOW,15,10,25
56,AMRITSAR,MUMBAI,96,107,203
57,AMRITSAR,PATNA,9,10,19
58,AMRITSAR,PUNE,18,21,39
59,AMRITSAR,SRINAGAR,35,37,72
60,BHUBANESWAR,CHANDIGARH,6,5,11
61,BHUBANESWAR,CHENNAI,69,73,142
62,BHUBANESWAR,DEHRA DUN,22,1,23
63,BHUBANESWAR,DELHI,344,345,689
64,BHUBANESWAR,HYDERABAD,96,102,198
65,BHUBANESWAR,JAIPUR,15,17,32
66,BHUBANESWAR,JHARSUGUDA,12,12,24
67,BHUBANESWAR,KOLKATA,156,155,311
68,ALLAHABAD,JABALPUR,1,1,2
69,BHUBANESWAR,LUCKNOW,1,1,2
70,BHUBANESWAR,MUMBAI,204,201,405
71,BHUBANESWAR,PATNA,30,25,55
72,BHUBANESWAR,PUNE,25,29,54
73,BHUBANESWAR,RAIPUR,3,2,5
74,AMRITSAR,CHANDIGARH,1,23,24
75,BHUBANESWAR,RANCHI,4,4,8
76,BHUBANESWAR,VARANASI,15,15,30
77,BAREILLY,BENGALURU,14,17,31
78,BAREILLY,DELHI,15,13,28
79,BAREILLY,MUMBAI,18,20,38
80,BHUJ,MUMBAI,10,11,21
81,BHOPAL,DELHI,168,159,327
82,BHOPAL,HYDERABAD,19,20,39
83,BHOPAL,INDORE,1,23,24
84,BHOPAL,KOCHI,6,7,13
85,BHOPAL,MUMBAI,116,111,227
86,BHOPAL,RAIPUR,18,17,35
87,BHAVNAGAR,MUMBAI,17,18,35
88,BHAVNAGAR,PUNE,10,9,19
89,BIKANER,DELHI,12,13,25
90,BENGALURU,BHOPAL,33,31,64
91,BENGALURU,BHUBANESWAR,204,185,389
92,BENGALURU,"BIDAR AIRPORT, KARNATAKA",6,6,12
93,BENGALURU,CHANDIGARH,140,106,246
94,BENGALURU,CHENNAI,362,383,745
95,BENGALURU,COIMBATORE,80,90,170
96,BAGDOGRA,RANCHI,1,1,2
97,BAGDOGRA,SILCHAR,2,23,25
98,BENGALURU,DABOLIM,383,365,748
99,BENGALURU,DARBHANGA,46,36,82
100,BENGALURU,DEHRA DUN,47,41,88
101,BENGALURU,DELHI,1597,1452,3049
102,BENGALURU,DIMAPUR,9,5,14
103,BENGALURU,DURGAPUR,38,35,73
104,BENGALURU,GORAKHPUR,9,9,18
105,BENGALURU,GUWAHATI,134,119,253
106,BENGALURU,GWALIOR,15,13,28
107,BENGALURU,HUBLI,44,45,89
108,BENGALURU,HYDERABAD,594,588,1182
109,BENGALURU,IMPHAL,2,3,5
110,BENGALURU,INDORE,117,108,225
111,BENGALURU,JABALPUR,16,14,30
112,BENGALURU,JAIPUR,182,164,346
113,BENGALURU,JAMMU,4,3,7
114,BENGALURU,JAMNAGAR,5,4,9
115,BENGALURU,JODHPUR,41,40,81
116,BENGALURU,JORHAT,6,6,12
117,BENGALURU,KADAPA,3,4,7
118,BENGALURU,"KALABURAGI, KARNATAKA",26,26,52
119,BENGALURU,KANNUR,29,29,58
120,BENGALURU,KANPUR,20,22,42
121,BENGALURU,KOCHI,632,653,1285
122,BENGALURU,KOLHAPUR,7,6,13
123,BENGALURU,KOLKATA,616,513,1129
124,BENGALURU,KOZHIKODE,43,42,85
125,BENGALURU,KURNOOL,3,4,7
126,BENGALURU,LUCKNOW,215,188,403
127,BENGALURU,MADURAI,53,54,107
128,BENGALURU,MANGALORE,181,182,363
129,BENGALURU,MUMBAI,1461,1388,2849
130,BENGALURU,MYSORE,4,7,11
131,BENGALURU,NAGPUR,83,81,164
132,BENGALURU,PATNA,152,140,292
133,BENGALURU,PONDICHERRY,10,10,20
134,BENGALURU,PORT BLAIR,48,46,94
135,BENGALURU,PUNE,517,520,1037
136,BENGALURU,RAIPUR,86,73,159
137,BENGALURU,RAJAHMUNDRY,29,30,59
138,BENGALURU,RAJKOT,36,31,67
139,BENGALURU,RANCHI,158,119,277
140,BENGALURU,SHIRDI,63,58,121
141,BENGALURU,SRINAGAR,8,9,17
142,BENGALURU,SURAT,42,37,79
143,BENGALURU,TIRUCHIRAPALLY,36,35,71
144,BENGALURU,TIRUPATI,19,18,37
145,BENGALURU,TRIVANDRUM,149,152,301
146,BENGALURU,TUTICORIN,18,16,34
147,BENGALURU,UDAIPUR,34,29,63
148,BENGALURU,VADODARA,50,42,92
149,BENGALURU,VARANASI,113,96,209
150,BENGALURU,VIJAYAWADA,65,73,138
151,BENGALURU,VISAKHAPATNAM,139,143,282
152,MUMBAI,NAGPUR,269,298,567
153,MUMBAI,PATNA,188,174,362
154,MUMBAI,PORT BLAIR,1,23,24
155,MUMBAI,PUNE,1,1,2
156,MUMBAI,RAIPUR,150,152,302
157,MUMBAI,RAJKOT,131,124,255
158,MUMBAI,RANCHI,118,111,229
159,MUMBAI,SILCHAR,1,1,2
160,MUMBAI,SRINAGAR,85,145,230
161,MUMBAI,SURAT,13,14,27
162,MUMBAI,TIRUPATI,11,10,21
163,MUMBAI,TRIVANDRUM,119,145,264
164,MUMBAI,UDAIPUR,185,180,365
165,MUMBAI,VADODARA,141,144,285
166,MUMBAI,VARANASI,211,181,392
167,MUMBAI,VISAKHAPATNAM,42,54,96
168,MUMBAI,Sindhudurg Airport,17,16,33
169,KOZHIKODE,MUMBAI,69,58,127
170,KOLKATA,LILABARI,8,9,17
171,KOLKATA,LUCKNOW,94,104,198
172,KOLKATA,MANGALORE,3,3,6
173,KOLKATA,MUMBAI,588,612,1200
174,KOLKATA,NAGPUR,34,38,72
175,KOLKATA,PASIGHAT,22,1,23
176,KOLKATA,PATNA,83,92,175
177,KOLKATA,PORT BLAIR,162,155,317
178,KOLKATA,PUNE,104,121,225
179,KOLKATA,RAIPUR,68,75,143
180,KOLKATA,RANCHI,53,55,108
181,KOLKATA,RUPSI,12,12,24
182,KOLKATA,SHILLONG,15,12,27
183,KOLKATA,SILCHAR,84,85,169
184,KOLKATA,SRINAGAR,8,9,17
185,KOLKATA,SURAT,43,50,93
186,KOLKATA,TEZPUR,22,3,25
187,KOLKATA,TRIVANDRUM,5,5,10
188,KOLKATA,UDAIPUR,4,3,7
189,KOLKATA,VARANASI,38,47,85
190,KOLKATA,VISAKHAPATNAM,41,50,91
191,KADAPA,VIJAYAWADA,3,3,6
192,KADAPA,VISAKHAPATNAM,4,4,8
193,COIMBATORE,DELHI,159,138,297
194,COIMBATORE,GUWAHATI,6,2,8
195,COIMBATORE,HYDERABAD,170,167,337
196,COIMBATORE,JAIPUR,6,3,9
197,COIMBATORE,MANGALORE,22,4,26
198,COIMBATORE,MUMBAI,176,159,335
199,COIMBATORE,PUNE,28,20,48
200,COIMBATORE,SURAT,7,7,14
201,COIMBATORE,TIRUPATI,4,5,9
202,COIMBATORE,VISAKHAPATNAM,22,3,25
203,KANNUR,KOCHI,19,17,36
204,KANNUR,KOZHIKODE,1,2,3
205,KANNUR,MUMBAI,51,49,100
206,KANNUR,TRIVANDRUM,16,18,34
207,CHANDIGARH,JAMMU,1,23,24
208,KOCHI,KOLKATA,25,27,52
209,KOCHI,MUMBAI,320,285,605
210,KOCHI,MYSORE,9,9,18
211,KOCHI,PUNE,37,37,74
212,KOCHI,RANCHI,4,3,7
213,KOCHI,TRIVANDRUM,19,18,37
214,DARBHANGA,DELHI,41,46,87
215,CHANDIGARH,RAIPUR,22,1,23
216,DARBHANGA,HYDERABAD,31,31,62
217,DARBHANGA,KOLKATA,19,14,33
218,DARBHANGA,MUMBAI,32,40,72
219,DEHRA DUN,DELHI,247,263,510
220,DEHRA DUN,GUWAHATI,5,2,7
221,DEHRA DUN,HYDERABAD,37,42,79
222,DEHRA DUN,JAIPUR,19,16,35
223,DEHRA DUN,KOLKATA,15,15,30
224,DEHRA DUN,LUCKNOW,27,33,60
225,DEHRA DUN,MUMBAI,110,136,246
226,DEHRA DUN,PANTNAGAR,9,9,18
227,DEHRA DUN,PUNE,8,10,18
228,DEHRA DUN,VARANASI,10,8,18
229,DELHI,DHARAMSALA,52,44,96
230,DELHI,DIBRUGARH,78,74,152
231,DELHI,DIMAPUR,24,25,49
232,DELHI,DURGAPUR,45,38,83
233,DELHI,GAYA,38,37,75
234,DELHI,GORAKHPUR,111,99,210
235,DELHI,GUWAHATI,527,514,1041
236,DELHI,GWALIOR,24,30,54
237,DELHI,HYDERABAD,900,1007,1907
238,DELHI,IMPHAL,84,81,165
239,DELHI,INDORE,253,254,507
240,DELHI,JABALPUR,49,49,98
241,DELHI,JAGDALPUR,3,4,7
242,DELHI,JAIPUR,219,207,426
243,DELHI,JAMMU,348,347,695
244,DELHI,JHARSUGUDA,23,24,47
245,DELHI,JODHPUR,84,81,165
246,DELHI,JORHAT,7,5,12
247,DELHI,KANDLA,11,10,21
248,DELHI,KANNUR,10,14,24
249,DELHI,KANPUR,15,13,28
250,DELHI,KHAJURAHO,5,4,9
251,DELHI,KOCHI,310,363,673
252,DELHI,KOLKATA,1019,938,1957
253,DELHI,KOZHIKODE,79,86,165
254,DELHI,KULLU,7,4,11
255,CHENNAI,TIRUPATI,1,23,24
256,DELHI,LEH,370,401,771
257,DELHI,LUCKNOW,494,509,1003
258,CHENNAI,UDAIPUR,1,1,2
259,DELHI,MADURAI,27,30,57
260,DELHI,MANGALORE,15,16,31
261,DELHI,MUMBAI,1973,2010,3983
262,DELHI,NAGPUR,159,172,331
263,DELHI,NASIK,25,29,54
264,DELHI,PANTNAGAR,21,21,42
265,DELHI,PATHANKOT,5,6,11
266,DELHI,PATNA,572,519,1091
267,DELHI,PORT BLAIR,43,39,82
268,DELHI,PUNE,871,925,1796
269,DELHI,RAIPUR,253,271,524
270,DELHI,RAJKOT,123,125,248
271,DELHI,RANCHI,269,259,528
272,DELHI,SHIRDI,82,82,164
273,DELHI,SILCHAR,18,15,33
274,DELHI,SRINAGAR,929,931,1860
275,DELHI,SURAT,164,160,324
276,DELHI,TIRUCHIRAPALLY,9,10,19
277,DELHI,TIRUPATI,26,19,45
278,DELHI,TRIVANDRUM,85,94,179
279,DELHI,UDAIPUR,158,158,316
280,DELHI,VADODARA,152,158,310
281,DELHI,VARANASI,266,250,516
282,DELHI,VIJAYAWADA,77,87,164
283,DELHI,VISAKHAPATNAM,147,160,307
284,DELHI,Kushinagar International Airport,3,3,6
285,DHARAMSALA,JAIPUR,22,1,23
286,DIBRUGARH,DIMAPUR,1,1,2
287,DIBRUGARH,GUWAHATI,21,15,36
288,DABOLIM,VARANASI,1,23,24
289,DIBRUGARH,IMPHAL,7,9,16
290,DIBRUGARH,KOLKATA,84,85,169
291,DIBRUGARH,MUMBAI,3,5,8
292,DIBRUGARH,SHILLONG,2,2,4
293,DIU,MUMBAI,16,16,32
294,DIMAPUR,GUWAHATI,7,7,14
295,DIMAPUR,IMPHAL,11,13,24
296,DIMAPUR,KOLKATA,56,45,101
297,DIMAPUR,MUMBAI,1,2,3
298,DIMAPUR,SHILLONG,1,1,2
299,GUWAHATI,HYDERABAD,49,48,97
300,GUWAHATI,IMPHAL,158,173,331
301,GUWAHATI,JAIPUR,36,38,74
302,GUWAHATI,JODHPUR,1,1,2
303,GUWAHATI,JORHAT,11,13,24
304,GUWAHATI,KOLKATA,293,315,608
305,GUWAHATI,LUCKNOW,30,24,54
306,GUWAHATI,MUMBAI,123,127,250
307,GUWAHATI,PASIGHAT,5,5,10
308,GUWAHATI,PATNA,33,37,70
309,GUWAHATI,PUNE,2,23,25
310,GUWAHATI,RUPSI,9,7,16
311,GUWAHATI,SHILLONG,1,1,2
312,GUWAHATI,SILCHAR,36,38,74
313,GUWAHATI,TEZPUR,2,1,3
314,GUWAHATI,TEZU,7,8,15
315,GUWAHATI,VARANASI,4,4,8
316,GAYA,KOLKATA,10,10,20
317,"KALABURAGI, KARNATAKA",TIRUPATI,3,2,5
318,DABOLIM,DELHI,705,712,1417
319,DABOLIM,GUWAHATI,3,23,26
320,DABOLIM,HYDERABAD,311,333,644
321,DABOLIM,INDORE,31,31,62
322,DABOLIM,JAIPUR,13,17,30
323,DABOLIM,KOLKATA,55,56,111
324,DABOLIM,LUCKNOW,65,68,133
325,DABOLIM,MUMBAI,780,746,1526
326,DABOLIM,MYSORE,10,11,21
327,DABOLIM,PUNE,81,78,159
328,DABOLIM,RAIPUR,8,10,18
329,DABOLIM,RAJKOT,13,11,24
330,DABOLIM,SURAT,47,47,94
331,GORAKHPUR,HYDERABAD,30,33,63
332,DELHI,PAKYONG,7,5,12
333,GORAKHPUR,KOLKATA,17,16,33
334,GORAKHPUR,LUCKNOW,5,23,28
335,GORAKHPUR,MUMBAI,57,60,117
336,GWALIOR,HYDERABAD,2,2,4
337,GWALIOR,INDORE,4,4,8
338,GWALIOR,KOLKATA,6,5,11
339,GWALIOR,MUMBAI,2,2,4
340,HUBLI,HYDERABAD,19,18,37
341,HUBLI,MANGALORE,5,5,10
342,HUBLI,MUMBAI,18,19,37
343,HUBLI,MYSORE,3,2,5
344,HYDERABAD,IMPHAL,2,3,5
345,HYDERABAD,INDORE,99,95,194
346,HYDERABAD,JABALPUR,19,19,38
347,HYDERABAD,JAGDALPUR,11,11,22
348,HYDERABAD,JAIPUR,147,123,270
349,HYDERABAD,JAMMU,2,23,25
350,HYDERABAD,JAMNAGAR,4,4,8
351,HYDERABAD,JODHPUR,16,14,30
352,HYDERABAD,KADAPA,13,13,26
353,HYDERABAD,KANNUR,16,17,33
354,HYDERABAD,KOCHI,231,205,436
355,HYDERABAD,KOLHAPUR,29,28,57
356,HYDERABAD,KOLKATA,340,272,612
357,HYDERABAD,KOZHIKODE,16,17,33
358,HYDERABAD,LUCKNOW,85,81,166
359,HYDERABAD,MADURAI,43,44,87
360,HYDERABAD,MANGALORE,38,37,75
361,HYDERABAD,MUMBAI,703,623,1326
362,HYDERABAD,MYSORE,27,23,50
363,HYDERABAD,NAGPUR,21,22,43
364,HYDERABAD,NASIK,17,16,33
365,HYDERABAD,PATNA,88,65,153
366,HYDERABAD,PONDICHERRY,21,21,42
367,HYDERABAD,PUNE,173,161,334
368,DURGAPUR,SHIRDI,22,1,23
369,HYDERABAD,RAIPUR,72,71,143
370,HYDERABAD,RAJAHMUNDRY,90,89,179
371,HYDERABAD,RANCHI,46,47,93
372,GAYA,JAIPUR,1,23,24
373,HYDERABAD,SHIRDI,61,64,125
374,HYDERABAD,SRINAGAR,30,27,57
375,HYDERABAD,SURAT,22,24,46
376,HYDERABAD,TIRUCHIRAPALLY,31,30,61
377,HYDERABAD,TIRUPATI,193,195,388
378,HYDERABAD,TRIVANDRUM,53,52,105
379,HYDERABAD,UDAIPUR,26,28,54
380,HYDERABAD,VADODARA,50,47,97
381,HYDERABAD,VARANASI,91,87,178
382,HYDERABAD,VIJAYAWADA,92,93,185
383,HYDERABAD,VISAKHAPATNAM,226,238,464
384,INDORE,JABALPUR,11,12,23
385,INDORE,JAIPUR,20,20,40
386,INDORE,JAMMU,7,6,13
387,INDORE,KOLKATA,32,29,61
388,INDORE,LUCKNOW,15,18,33
389,INDORE,MUMBAI,222,214,436
390,INDORE,NAGPUR,17,19,36
391,INDORE,PUNE,36,29,65
392,INDORE,RAIPUR,31,25,56
393,IMPHAL,KOLKATA,127,107,234
394,IMPHAL,MUMBAI,3,2,5
395,IMPHAL,SHILLONG,7,6,13
396,NASIK,PUNE,10,9,19
397,AGARTALA,AHMEDABAD,2,5,7
398,AGARTALA,AIZAWL,5,5,10
399,AGARTALA,BENGALURU,39,48,87
400,AGARTALA,CHENNAI,4,2,6
401,AGARTALA,DELHI,43,39,82
402,AGARTALA,DIBRUGARH,9,11,20
403,AGARTALA,GUWAHATI,48,54,102
404,AGARTALA,IMPHAL,9,15,24
405,AGARTALA,KOLKATA,325,328,653
406,AGARTALA,SHILLONG,6,6,12
407,BAGDOGRA,BENGALURU,128,139,267
408,BAGDOGRA,CHENNAI,44,46,90
409,BAGDOGRA,DELHI,361,389,750
410,BAGDOGRA,DIBRUGARH,29,23,52
411,BAGDOGRA,HYDERABAD,44,47,91
412,BAGDOGRA,KOLKATA,221,215,436
413,BAGDOGRA,MUMBAI,75,74,149
414,CHANDIGARH,CHENNAI,32,40,72
415,CHANDIGARH,DABOLIM,59,63,122
416,CHANDIGARH,DELHI,277,295,572
417,CHANDIGARH,DHARAMSALA,10,10,20
418,CHANDIGARH,GUWAHATI,12,7,19
419,CHANDIGARH,HYDERABAD,63,87,150
420,CHANDIGARH,JAIPUR,37,30,67
421,CHANDIGARH,KOLKATA,22,29,51
422,CHANDIGARH,KULLU,5,1,6
423,CHANDIGARH,LEH,3,12,15
424,CHANDIGARH,LUCKNOW,29,28,57
425,CHANDIGARH,MUMBAI,249,263,512
426,CHANDIGARH,PATNA,26,25,51
427,CHANDIGARH,PUNE,42,38,80
428,CHANDIGARH,SRINAGAR,95,108,203
429,CHANDIGARH,VADODARA,22,1,23
430,ALLAHABAD,BENGALURU,20,21,41
431,ALLAHABAD,BHOPAL,5,5,10
432,ALLAHABAD,BHUBANESWAR,14,17,31
433,ALLAHABAD,BILASPUR,4,4,8
434,ALLAHABAD,DEHRA DUN,9,9,18
435,ALLAHABAD,DELHI,48,48,96
436,ALLAHABAD,GORAKHPUR,6,5,11
437,ALLAHABAD,INDORE,12,11,23
438,ALLAHABAD,LUCKNOW,9,6,15
439,ALLAHABAD,MUMBAI,29,30,59
440,ALLAHABAD,PUNE,15,17,32
441,ALLAHABAD,RAIPUR,14,17,31
442,MANGALORE,MUMBAI,216,187,403
443,BELGAUM,BENGALURU,19,17,36
444,BELGAUM,DELHI,22,18,40
445,BELGAUM,HYDERABAD,20,19,39
446,BELGAUM,INDORE,3,3,6
447,BELGAUM,JODHPUR,4,4,8
448,IMPHAL,TEZU,2,2,4
449,BELGAUM,MUMBAI,20,19,39
450,BELGAUM,NAGPUR,2,2,4
451,BELGAUM,NASIK,5,4,9
452,INDORE,JODHPUR,10,8,18
453,BELGAUM,PUNE,9,8,17
454,BELGAUM,SURAT,3,3,6
455,BELGAUM,TIRUPATI,3,3,6
456,JAMMU,LEH,17,24,41
457,JAMMU,MUMBAI,16,70,86
458,JAMMU,SRINAGAR,165,145,310
459,LEH,MUMBAI,22,27,49
460,LEH,SRINAGAR,80,11,91
461,MADURAI,MUMBAI,67,59,126
462,MADURAI,TIRUPATI,9,9,18
463,MADURAI,VIJAYAWADA,1,1,2
464,PASIGHAT,TEZPUR,1,1,2
465,AURANGABAD,DELHI,66,52,118
466,AURANGABAD,HYDERABAD,20,19,39
467,AURANGABAD,MUMBAI,79,76,155
468,KANDLA,MUMBAI,22,22,44
469,PORT BLAIR,VISAKHAPATNAM,11,14,25
470,JAIPUR,KOLKATA,114,123,237
471,JAIPUR,LUCKNOW,18,17,35
472,JAIPUR,MUMBAI,311,328,639
473,JAIPUR,PATNA,22,1,23
474,JAIPUR,PUNE,89,81,170
475,JAIPUR,SURAT,25,28,53
476,JAIPUR,UDAIPUR,19,15,34
477,JAIPUR,VADODARA,2,2,4
478,JAIPUR,VARANASI,7,5,12
479,JODHPUR,KOLKATA,8,8,16
480,JODHPUR,MUMBAI,73,77,150
481,JAMNAGAR,MUMBAI,32,40,72
482,JAGDALPUR,RAIPUR,11,11,22
483,JABALPUR,KOLKATA,5,5,10
484,JABALPUR,MUMBAI,30,29,59
485,JABALPUR,PUNE,13,13,26
486,JHARSUGUDA,KOLKATA,10,10,20
487,JHARSUGUDA,RAIPUR,8,5,13
488,JORHAT,KOLKATA,28,32,60
489,KURNOOL,VISAKHAPATNAM,5,4,9
490,KOLHAPUR,TIRUPATI,12,16,28
491,KANPUR,MUMBAI,40,42,82
492,AJMER,INDORE,2,3,5
493,AJMER,MUMBAI,2,2,4
494,AJMER,SURAT,3,3,6
495,LUCKNOW,MUMBAI,233,264,497
496,LUCKNOW,NAGPUR,16,14,30
497,LUCKNOW,PANTNAGAR,7,6,13
498,LUCKNOW,PATNA,35,33,68
499,LUCKNOW,PUNE,16,13,29
500,KOLKATA,PAKYONG,5,4,9
501,LUCKNOW,RAIPUR,2,3,5
502,LUCKNOW,RANCHI,25,28,53
503,LUCKNOW,SRINAGAR,4,4,8
504,LUCKNOW,VARANASI,22,2,24
505,CHENNAI,COIMBATORE,317,311,628
506,CHENNAI,DABOLIM,45,42,87
507,CHENNAI,DARBHANGA,3,1,4
508,CHENNAI,DEHRA DUN,13,10,23
509,CHENNAI,DELHI,791,697,1488
510,CHENNAI,DIBRUGARH,5,3,8
511,CHENNAI,DURGAPUR,38,36,74
512,CHENNAI,GUWAHATI,104,111,215
513,CHENNAI,HUBLI,15,16,31
514,CHENNAI,HYDERABAD,363,362,725
515,CHENNAI,INDORE,14,13,27
516,CHENNAI,JAIPUR,45,39,84
517,CHENNAI,JODHPUR,45,45,90
518,CHENNAI,KADAPA,4,4,8
519,CHENNAI,KANNUR,15,14,29
520,CHENNAI,KOCHI,180,176,356
521,CHENNAI,KOLKATA,298,284,582
522,CHENNAI,KOZHIKODE,18,17,35
523,CHENNAI,KURNOOL,4,4,8
524,CHENNAI,LUCKNOW,32,29,61
525,CHENNAI,MADURAI,130,129,259
526,CHENNAI,MANGALORE,18,17,35
527,CHENNAI,MUMBAI,939,792,1731
528,CHENNAI,MYSORE,20,16,36
529,CHENNAI,PATNA,20,18,38
530,CHENNAI,PORT BLAIR,218,196,414
531,CHENNAI,PUNE,172,180,352
532,CHENNAI,RAIPUR,24,24,48
533,CHENNAI,RAJAHMUNDRY,22,23,45
534,CHENNAI,RANCHI,32,37,69
535,CHENNAI,SHIRDI,60,55,115
536,CHENNAI,SRINAGAR,4,5,9
537,CHENNAI,SURAT,42,38,80
538,CHENNAI,TIRUCHIRAPALLY,70,68,138
539,CHENNAI,TRIVANDRUM,133,140,273
540,CHENNAI,TUTICORIN,54,52,106
541,CHENNAI,VADODARA,2,2,4
542,CHENNAI,VARANASI,26,23,49
543,CHENNAI,VIJAYAWADA,33,41,74
544,CHENNAI,VISAKHAPATNAM,96,104,200
545,NAGPUR,PUNE,124,107,231
546,BILASPUR,DELHI,4,5,9
547,BILASPUR,JABALPUR,3,4,7
548,PATNA,PUNE,43,39,82
549,PATNA,RANCHI,34,31,65
550,PUNE,RAIPUR,17,20,37
551,PUNE,RANCHI,39,41,80
552,PUNE,TIRUPATI,4,4,8
553,DURGAPUR,HYDERABAD,22,21,43
554,DURGAPUR,MUMBAI,28,31,59
555,DURGAPUR,SRINAGAR,22,1,23
556,DURGAPUR,TRIVANDRUM,1,1,2
557,RAJAHMUNDRY,TIRUPATI,5,4,9
558,RAJAHMUNDRY,VISAKHAPATNAM,4,4,8
559,RAIPUR,SRINAGAR,4,4,8
560,RAJAHMUNDRY,VIJAYAWADA,22,1,23
561,RAIPUR,VISAKHAPATNAM,4,23,27
562,SHIRDI,TIRUPATI,5,6,11
563,SHIRDI,VISAKHAPATNAM,1,23,24
564,SHILLONG,SILCHAR,3,3,6
565,TIRUPATI,VIJAYAWADA,8,9,17
566,TIRUPATI,VISAKHAPATNAM,13,15,28
567,GHAZIABAD,HUBLI,7,7,14
568,GHAZIABAD,"KALABURAGI, KARNATAKA",3,3,6
569,VIJAYAWADA,VISAKHAPATNAM,15,16,31
570,Deoghar Airport,KOLKATA,5,4,9
571,Deoghar Airport,DELHI,25,27,52
